id,district_id,forecast_area_id,district_region_id,planning_area_id,inhabitants,inhabitants_with_migration_background,inhabitants_germans,inhabitants_germans_without_migration_background,inhabitants_germans_with_migration_background,inhabitants_foreigners,inhabitants_percentage,inhabitants_with_migration_background_percentage,inhabitants_germans_percentage,inhabitants_germans_without_migration_background_percentage,inhabitants_germans_with_migration_background_percentage,inhabitants_foreigners_percentage
01011101,01,01,11,01,3114,1747,1907,1367,540,1207,100.0,56.1014771997431,61.23956326268465,43.898522800256906,17.341040462427745,38.76043673731535
01011102,01,01,11,02,192,71,140,121,19,52,100.0,36.97916666666667,72.91666666666666,63.020833333333336,9.895833333333332,27.083333333333332
01011103,01,01,11,03,5518,3248,3370,2270,1100,2148,100.0,58.861906487857915,61.07285248278361,41.138093512142085,19.934758970641536,38.92714751721638
01011104,01,01,11,04,4704,3030,2904,1674,1230,1800,100.0,64.41326530612244,61.73469387755102,35.58673469387755,26.147959183673468,38.265306122448976
01011105,01,01,11,05,1135,657,677,478,199,458,100.0,57.885462555066084,59.647577092511014,42.114537444933916,17.53303964757709,40.352422907488986
01011201,01,01,12,01,2190,1171,1418,1019,399,772,100.0,53.4703196347032,64.74885844748859,46.529680365296805,18.21917808219178,35.25114155251142
01011202,01,01,12,02,608,288,387,320,67,221,100.0,47.368421052631575,63.651315789473685,52.63157894736842,11.019736842105262,36.348684210526315
01011203,01,01,12,03,1004,512,629,492,137,375,100.0,50.99601593625498,62.64940239043825,49.00398406374502,13.645418326693227,37.35059760956175
01011204,01,01,12,04,7463,3303,5287,4160,1127,2176,100.0,44.258341149671715,70.84282460136674,55.74165885032829,15.101165751038456,29.157175398633257
01011301,01,01,13,01,6431,2538,4616,3893,723,1815,100.0,39.465090965635206,71.77732856476442,60.534909034364794,11.242419530399626,28.22267143523558
01011302,01,01,13,02,12535,4699,9289,7836,1453,3246,100.0,37.48703629836458,74.10450737933786,62.512963701635414,11.591543677702433,25.895492620662147
01011303,01,01,13,03,9536,4169,6457,5367,1090,3079,100.0,43.71854026845637,67.7118288590604,56.28145973154363,11.430369127516778,32.288171140939596
01011304,01,01,13,04,8607,3084,6683,5523,1160,1924,100.0,35.83130010456605,77.64610200999186,64.16869989543395,13.477402114557918,22.353897990008136
01011305,01,01,13,05,7617,2653,5878,4964,914,1739,100.0,34.82998555861888,77.16948930024944,65.17001444138111,11.999474858868322,22.83051069975056
01011306,01,01,13,06,9530,3726,6981,5804,1177,2549,100.0,39.09758656873032,73.25288562434417,60.90241343126968,12.350472193074502,26.747114375655823
01011401,01,01,14,01,16331,6296,11787,10035,1752,4544,100.0,38.55244626783418,72.17561692486682,61.447553732165815,10.728063192700999,27.82438307513318
01011402,01,01,14,02,13341,4877,9962,8464,1498,3379,100.0,36.55648002398621,74.67206356345102,63.443519976013796,11.228543587437223,25.32793643654899
01022101,01,02,21,01,3522,1825,2266,1697,569,1256,100.0,51.817149346961955,64.33844406587166,48.182850653038045,16.155593412833618,35.66155593412834
01022102,01,02,21,02,6374,3719,3821,2655,1166,2553,100.0,58.34640727957326,59.946658299341074,41.65359272042674,18.293065578914337,40.053341700658926
01022103,01,02,21,03,258,186,126,72,54,132,100.0,72.09302325581395,48.837209302325576,27.906976744186046,20.930232558139537,51.162790697674424
01022104,01,02,21,04,18377,8842,12699,9535,3164,5678,100.0,48.11449093976166,69.10268270120258,51.88550906023834,17.217173640964248,30.89731729879741
01022105,01,02,21,05,5299,3064,3368,2235,1133,1931,100.0,57.822230609548974,63.55916210605774,42.17776939045103,21.38139271560672,36.44083789394225
01022106,01,02,21,06,11799,4232,9209,7567,1642,2590,100.0,35.86744639376218,78.04898720230527,64.13255360623782,13.916433596067462,21.95101279769472
01022201,01,02,22,01,11292,5663,7701,5629,2072,3591,100.0,50.15054906128233,68.19872476089267,49.84945093871767,18.34927382217499,31.801275239107333
01022202,01,02,22,02,1488,972,1006,516,490,482,100.0,65.32258064516128,67.60752688172043,34.67741935483871,32.93010752688172,32.39247311827957
01022203,01,02,22,03,6969,4057,4647,2912,1735,2322,100.0,58.21495192997561,66.68101592767972,41.785048070024395,24.89596785765533,33.318984072320276
01022204,01,02,22,04,5824,2334,4363,3490,873,1461,100.0,40.07554945054945,74.91414835164835,59.92445054945055,14.989697802197801,25.08585164835165
01022205,01,02,22,05,3311,1969,2278,1342,936,1033,100.0,59.46843853820598,68.80096647538508,40.53156146179402,28.269405013591058,31.199033524614922
01022206,01,02,22,06,3027,1195,2379,1832,547,648,100.0,39.478031053848696,78.59266600594648,60.521968946151304,18.070697059795176,21.407333994053516
01022207,01,02,22,07,5630,2468,3885,3162,723,1745,100.0,43.83658969804618,69.00532859680284,56.16341030195382,12.841918294849023,30.99467140319716
01033101,01,03,31,01,26841,16504,15890,10337,5553,10951,100.0,61.48802205581014,59.20047688238144,38.51197794418986,20.68849893819157,40.79952311761857
01033102,01,03,31,02,11837,7182,7328,4655,2673,4509,100.0,60.67415730337079,61.907577933598034,39.325842696629216,22.58173523696883,38.09242206640196
01033201,01,03,32,01,13361,8873,9177,4488,4689,4184,100.0,66.40969987276402,68.68497866926128,33.590300127235984,35.0946785420253,31.31502133073872
01033202,01,03,32,02,9726,5343,7171,4383,2788,2555,100.0,54.93522516964836,73.73020769072589,45.06477483035163,28.665432860374256,26.26979230927411
01033203,01,03,32,03,14478,9098,8835,5380,3455,5643,100.0,62.840171294377676,61.023622047244096,37.159828705622324,23.863793341621772,38.976377952755904
01044101,01,04,41,01,20722,9735,14432,10987,3445,6290,100.0,46.979056075668375,69.64578708618859,53.02094392433163,16.624843161856965,30.354212913811406
01044102,01,04,41,02,16238,6159,12565,10079,2486,3673,100.0,37.92954797388841,77.3802192388225,62.07045202611159,15.309767212710925,22.619780761177484
01044103,01,04,41,03,8589,4451,5498,4138,1360,3091,100.0,51.82209803236698,64.01210851088601,48.17790196763302,15.834206543252998,35.987891489113984
01044201,01,04,42,01,23424,15744,13375,7680,5695,10049,100.0,67.21311475409836,57.099556010928964,32.78688524590164,24.31267076502732,42.90044398907104
01044202,01,04,42,02,16703,9539,10058,7164,2894,6645,100.0,57.10950128719392,60.216727533975934,42.890498712806085,17.32622882116985,39.783272466024066
01044203,01,04,42,03,16462,9510,10027,6952,3075,6435,100.0,57.76940833434576,60.90997448669664,42.23059166565423,18.679382821042402,39.09002551330337
02010101,02,01,01,01,6481,4617,3635,1864,1771,2846,100.0,71.23900632618422,56.08702360746798,28.760993673815772,27.32602993365221,43.912976392532016
02010102,02,01,01,02,13278,8933,9025,4345,4680,4253,100.0,67.27669829793643,67.96957373098358,32.72330170206356,35.24627202892002,32.03042626901642
02010103,02,01,01,03,15593,10842,10009,4751,5258,5584,100.0,69.53119989738985,64.18905919322772,30.468800102610142,33.72025909061758,35.810940806772265
02010104,02,01,01,04,5044,3252,3410,1792,1618,1634,100.0,64.47264076130055,67.60507533703411,35.52735923869945,32.077716098334655,32.3949246629659
02020201,02,02,02,01,911,443,642,468,174,269,100.0,48.62788144895719,70.47200878155873,51.37211855104281,19.099890230515918,29.527991218441272
02020202,02,02,02,02,5990,2535,4317,3455,862,1673,100.0,42.320534223706176,72.07011686143574,57.679465776293824,14.390651085141904,27.929883138564275
02020203,02,02,02,03,10886,4126,8343,6760,1583,2543,100.0,37.90189233878376,76.63972074223774,62.09810766121624,14.541613081021495,23.360279257762265
02020204,02,02,02,04,12326,5016,9152,7310,1842,3174,100.0,40.694466980366705,74.24955378873925,59.305533019633295,14.944020769105956,25.75044621126075
02020205,02,02,02,05,14892,5900,11271,8992,2279,3621,100.0,39.61858716089176,75.68493150684932,60.38141283910825,15.30351866774107,24.315068493150687
02020206,02,02,02,06,19052,8587,13829,10465,3364,5223,100.0,45.07138358177619,72.58555532227588,54.92861641822381,17.65693890405207,27.414444677724127
02030301,02,03,03,01,9092,5684,5624,3408,2216,3468,100.0,62.51649802023758,61.856577210734706,37.48350197976243,24.373075230972283,38.14342278926529
02030302,02,03,03,02,13166,6974,8845,6192,2653,4321,100.0,52.969770621297286,67.18061674008811,47.03022937870272,20.150387361385384,32.819383259911895
02030401,02,03,04,01,15156,7197,10405,7959,2446,4751,100.0,47.486144101346,68.6526788070731,52.51385589865399,16.138822908419108,31.34732119292689
02030402,02,03,04,02,11083,5413,7536,5670,1866,3547,100.0,48.84056663358297,67.99602995578815,51.15943336641704,16.83659658937111,32.003970044211854
02040501,02,04,05,01,5381,1263,4647,4118,529,734,100.0,23.47147370377253,86.35941274855975,76.52852629622745,9.83088645233228,13.640587251440254
02040502,02,04,05,02,7181,1831,6022,5350,672,1159,100.0,25.497841526249825,83.86018660353712,74.50215847375017,9.358028129786938,16.139813396462888
02040503,02,04,05,03,10976,2596,9223,8380,843,1753,100.0,23.651603498542272,84.02879008746356,76.34839650145773,7.680393586005831,15.971209912536445
02040701,02,04,07,01,12331,4341,9493,7990,1503,2838,100.0,35.20395750547401,76.98483496877788,64.79604249452599,12.188792474251887,23.015165031222125
02040702,02,04,07,02,10714,2446,9060,8268,792,1654,100.0,22.829942131790183,84.5622549934665,77.17005786820982,7.392197125256674,15.437745006533508
02040703,02,04,07,03,1145,762,485,383,102,660,100.0,66.55021834061135,42.35807860262008,33.44978165938864,8.90829694323144,57.64192139737992
02050601,02,05,06,01,8900,2452,7168,6448,720,1732,100.0,27.55056179775281,80.53932584269663,72.4494382022472,8.089887640449438,19.46067415730337
02050602,02,05,06,02,21064,5664,17100,15400,1700,3964,100.0,26.889479680972272,81.1811621724269,73.11052031902773,8.070641853399165,18.81883782757311
02050801,02,05,08,01,19093,5805,14833,13288,1545,4260,100.0,30.403812915728277,77.6881579636516,69.59618708427172,8.091970879379877,22.311842036348402
02050802,02,05,08,02,20431,5809,16096,14622,1474,4335,100.0,28.43228427389751,78.78224267045177,71.56771572610249,7.214526944349273,21.21775732954824
02050803,02,05,08,03,6986,1987,5571,4999,572,1415,100.0,28.44259948468365,79.7452046951045,71.55740051531635,8.187804179788149,20.254795304895506
02050804,02,05,08,04,4171,895,3650,3276,374,521,100.0,21.457684008631023,87.50899064972428,78.54231599136897,8.96667465835531,12.491009350275712
03010101,03,01,01,01,3928,469,3620,3459,161,308,100.0,11.939918533604887,92.15885947046843,88.06008146639512,4.09877800407332,7.841140529531568
03010102,03,01,01,02,11685,1530,10582,10155,427,1103,100.0,13.093709884467266,90.56054771074027,86.90629011553274,3.6542575952075307,9.439452289259735
03010104,03,01,01,04,227,52,197,175,22,30,100.0,22.90748898678414,86.78414096916299,77.09251101321586,9.691629955947137,13.215859030837004
03020203,03,02,02,03,2116,102,2083,2014,69,33,100.0,4.8204158790170135,98.44045368620039,95.17958412098298,3.260869565217391,1.559546313799622
03020209,03,02,02,09,14726,2092,13457,12634,823,1269,100.0,14.206165964959935,91.38258861876952,85.79383403504006,5.588754583729457,8.617411381230475
03020210,03,02,02,10,11132,1372,10331,9760,571,801,100.0,12.324829320876752,92.80452748832195,87.67517067912326,5.129356809198706,7.195472511678045
03020307,03,02,03,07,17930,1972,17194,15958,1236,736,100.0,10.998326826547686,95.89514779698828,89.00167317345232,6.893474623535973,4.1048522030117125
03030405,03,03,04,05,10986,1247,10359,9739,620,627,100.0,11.35081012197342,94.29273620972147,88.64918987802658,5.643546331694885,5.707263790278536
03030406,03,03,04,06,8245,602,7970,7643,327,275,100.0,7.301394784718012,96.66464523953911,92.69860521528199,3.966040024257125,3.3353547604608855
03030711,03,03,07,11,6810,356,6651,6454,197,159,100.0,5.227606461086638,97.66519823788546,94.77239353891336,2.8928046989720997,2.3348017621145374
03030715,03,03,07,15,7388,1188,6536,6200,336,852,100.0,16.080129940443964,88.46778559826745,83.91987005955603,4.547915538711424,11.532214401732539
03030716,03,03,07,16,1138,36,1118,1102,16,20,100.0,3.163444639718805,98.24253075571178,96.8365553602812,1.4059753954305798,1.7574692442882252
03040508,03,04,05,08,4530,844,4287,3686,601,243,100.0,18.631346578366443,94.63576158940398,81.36865342163355,13.26710816777042,5.364238410596026
03040512,03,04,05,12,9783,1233,9224,8550,674,559,100.0,12.603495860165593,94.28600633752427,87.3965041398344,6.88950219768987,5.7139936624757235
03040513,03,04,05,13,3412,452,3198,2960,238,214,100.0,13.247362250879249,93.72801875732708,86.75263774912075,6.97538100820633,6.271981242672919
03040614,03,04,06,14,35308,4326,32859,30982,1877,2449,100.0,12.252180808881839,93.06389486801858,87.74781919111815,5.316075676900419,6.936105131981421
03040818,03,04,08,18,34314,4831,31128,29483,1645,3186,100.0,14.078801655301042,90.71515999300577,85.92119834469895,4.793961648306814,9.28484000699423
03050919,03,05,09,19,5564,1032,4694,4532,162,870,100.0,18.54780733285406,84.36376707404744,81.45219266714594,2.9115744069015097,15.636232925952553
03050920,03,05,09,20,7397,955,6824,6442,382,573,100.0,12.910639448425037,92.25361633094498,87.08936055157497,5.164255779370015,7.746383669055022
03050923,03,05,09,23,9098,1582,8034,7516,518,1064,100.0,17.38843701912508,88.30512200483622,82.61156298087492,5.69355902396131,11.694877995163772
03050924,03,05,09,24,5883,1223,4984,4660,324,899,100.0,20.78871324154343,84.71868094509604,79.21128675845657,5.50739418663947,15.28131905490396
03050925,03,05,09,25,9468,1464,8545,8004,541,923,100.0,15.462610899873258,90.25137304604985,84.53738910012675,5.713983945923109,9.748626953950149
03051017,03,05,10,17,4247,739,3709,3508,201,538,100.0,17.40051801271486,87.33223451848363,82.59948198728515,4.732752531198494,12.667765481516364
03051021,03,05,10,21,6503,649,6027,5854,173,476,100.0,9.980009226510841,92.68030139935415,90.01999077348916,2.660310625864985,7.319698600645856
03051022,03,05,10,22,4527,274,4383,4253,130,144,100.0,6.0525734481996905,96.81908548707754,93.9474265518003,2.8716589352772255,3.180914512922465
03061126,03,06,11,26,15187,3881,12486,11306,1180,2701,100.0,25.554750773688024,82.21505234740238,74.44524922631199,7.769803121090406,17.784947652597616
03061131,03,06,11,31,10521,3281,8182,7240,942,2339,100.0,31.185248550518015,77.76827297785381,68.81475144948199,8.953521528371827,22.231727022146185
03061227,03,06,12,27,14520,3412,12236,11108,1128,2284,100.0,23.49862258953168,84.26997245179064,76.50137741046832,7.768595041322314,15.730027548209366
03061228,03,06,12,28,12619,2497,10896,10122,774,1723,100.0,19.787621840082416,86.34598621126872,80.21237815991759,6.133608051351137,13.654013788731278
03061332,03,06,13,32,22519,6464,18187,16055,2132,4332,100.0,28.70464940716728,80.76291131933034,71.29535059283272,9.467560726497624,19.237088680669657
03061429,03,06,14,29,10082,1295,9265,8787,478,817,100.0,12.844673675857965,91.89644911723865,87.15532632414204,4.741122793096608,8.103550882761358
03061430,03,06,14,30,3921,1435,2675,2486,189,1246,100.0,36.59780668196888,68.2223922468758,63.40219331803112,4.8201989288446825,31.777607753124204
03061434,03,06,14,34,6238,1396,5288,4842,446,950,100.0,22.378967617826227,84.77075985892914,77.62103238217377,7.14972747675537,15.229240141070857
03061435,03,06,14,35,3875,965,3209,2910,299,666,100.0,24.903225806451612,82.81290322580645,75.09677419354838,7.716129032258065,17.18709677419355
03061441,03,06,14,41,2560,648,2217,1912,305,343,100.0,25.3125,86.6015625,74.6875,11.9140625,13.398437499999998
03071536,03,07,15,36,10747,3628,8271,7119,1152,2476,100.0,33.75825811854471,76.96101237554667,66.24174188145528,10.719270494091376,23.038987624453338
03071537,03,07,15,37,15635,5114,11994,10521,1473,3641,100.0,32.70866645346978,76.71250399744164,67.29133354653023,9.421170450911417,23.287496002558363
03071633,03,07,16,33,3010,694,2583,2316,267,427,100.0,23.056478405315612,85.81395348837209,76.94352159468438,8.870431893687709,14.186046511627906
03071638,03,07,16,38,17260,5083,13831,12177,1654,3429,100.0,29.449594438006955,80.1332560834299,70.55040556199305,9.582850521436848,19.866743916570105
03071639,03,07,16,39,12367,3029,10409,9338,1071,1958,100.0,24.492601277593597,84.16754265383682,75.5073987224064,8.660143931430419,15.832457346163176
04010101,04,01,01,01,11043,5130,7925,5913,2012,3118,100.0,46.454767726161364,71.76491895318301,53.54523227383863,18.21968667934438,28.23508104681699
04010102,04,01,01,02,895,369,569,526,43,326,100.0,41.22905027932961,63.57541899441341,58.770949720670394,4.804469273743017,36.424581005586596
04010103,04,01,01,03,7771,3994,5823,3777,2046,1948,100.0,51.39621670312701,74.93244112726805,48.60378329687299,26.32865783039506,25.067558872731954
04020204,04,02,02,04,199,71,157,128,29,42,100.0,35.678391959798994,78.89447236180904,64.321608040201,14.572864321608039,21.105527638190953
04020205,04,02,02,05,1329,333,1129,996,133,200,100.0,25.056433408577877,84.95109104589918,74.94356659142211,10.00752445447705,15.04890895410083
04020206,04,02,02,06,2754,628,2388,2126,262,366,100.0,22.80319535221496,86.71023965141612,77.19680464778504,9.513435003631082,13.28976034858388
04020207,04,02,02,07,2532,698,2128,1834,294,404,100.0,27.567140600315952,84.04423380726699,72.43285939968405,11.61137440758294,15.955766192733018
04020208,04,02,02,08,2878,727,2490,2151,339,388,100.0,25.26059763724809,86.51841556636553,74.7394023627519,11.779013203613621,13.481584433634469
04020209,04,02,02,09,3189,1166,2301,2023,278,888,100.0,36.563185951709,72.15428033866415,63.436814048291,8.717466290373158,27.845719661335842
04020310,04,02,03,10,602,297,344,305,39,258,100.0,49.33554817275748,57.14285714285714,50.66445182724253,6.4784053156146175,42.857142857142854
04020311,04,02,03,11,14756,4529,11990,10227,1763,2766,100.0,30.69259962049336,81.25508267823258,69.30740037950665,11.947682298725942,18.744917321767414
04020312,04,02,03,12,5467,1681,4393,3786,607,1074,100.0,30.7481251143223,80.35485641119445,69.2518748856777,11.102981525516736,19.64514358880556
04020313,04,02,03,13,7530,2915,5622,4615,1007,1908,100.0,38.711819389110225,74.66135458167331,61.288180610889775,13.373173970783533,25.338645418326696
04020314,04,02,03,14,436,436,3,0,3,433,100.0,100.0,0.6880733944954129,0.0,0.6880733944954129,99.31192660550458
04030415,04,03,04,15,2837,1431,1762,1406,356,1075,100.0,50.440606274233346,62.10786041593232,49.559393725766654,12.548466690165668,37.89213958406768
04030416,04,03,04,16,10655,5103,7680,5552,2128,2975,100.0,47.893007977475364,72.07883622712342,52.106992022524636,19.971844204598778,27.921163772876582
04030417,04,03,04,17,10927,4051,8474,6876,1598,2453,100.0,37.073304658186146,77.55102040816327,62.926695341813854,14.624325066349408,22.448979591836736
04030518,04,03,05,18,9417,4021,7022,5396,1626,2395,100.0,42.69937347350536,74.56727195497504,57.30062652649464,17.266645428480405,25.432728045024955
04030519,04,03,05,19,5734,2464,4280,3270,1010,1454,100.0,42.971747471224276,74.64248343215904,57.028252528775724,17.614230903383326,25.35751656784095
04030620,04,03,06,20,8597,3699,6437,4898,1539,2160,100.0,43.026637199022915,74.8749563801326,56.97336280097709,17.90159357915552,25.125043619867395
04030621,04,03,06,21,3021,1609,2027,1412,615,994,100.0,53.26050976497848,67.09698775239987,46.73949023502151,20.357497517378352,32.90301224760013
04030622,04,03,06,22,10459,4759,7635,5700,1935,2824,100.0,45.50148197724448,72.9993307199541,54.498518022755526,18.500812697198583,27.00066928004589
04030623,04,03,06,23,4788,2617,3270,2171,1099,1518,100.0,54.65747702589808,68.29573934837093,45.342522974101925,22.953216374269005,31.704260651629074
04030724,04,03,07,24,6416,2236,5062,4180,882,1354,100.0,34.85037406483791,78.89650872817955,65.14962593516209,13.746882793017456,21.10349127182045
04030725,04,03,07,25,12128,4738,9021,7390,1631,3107,100.0,39.06662269129287,74.3815963060686,60.93337730870713,13.448218997361478,25.618403693931395
04030726,04,03,07,26,5426,2260,4038,3166,872,1388,100.0,41.651308514559524,74.41946185035016,58.348691485440476,16.070770364909695,25.580538149649833
04030827,04,03,08,27,12238,6345,8064,5893,2171,4174,100.0,51.84670697826442,65.89311979081549,48.15329302173558,17.739826769079915,34.10688020918451
04030828,04,03,08,28,9491,4110,6843,5381,1462,2648,100.0,43.304182910125384,72.09988410072701,56.69581708987462,15.404067010852387,27.900115899272997
04030929,04,03,09,29,5981,2514,4389,3467,922,1592,100.0,42.0331048319679,73.38237752884133,57.96689516803211,15.415482360809229,26.61762247115867
04030930,04,03,09,30,5600,2460,4001,3140,861,1599,100.0,43.92857142857143,71.44642857142857,56.07142857142857,15.375,28.553571428571427
04030931,04,03,09,31,3915,2259,2280,1656,624,1635,100.0,57.701149425287355,58.23754789272031,42.298850574712645,15.938697318007664,41.7624521072797
04031032,04,03,10,32,14931,5873,11474,9058,2416,3457,100.0,39.3342709798406,76.84682874556292,60.6657290201594,16.181099725403524,23.153171254437076
04041133,04,04,11,33,43,15,34,28,6,9,100.0,34.883720930232556,79.06976744186046,65.11627906976744,13.953488372093023,20.930232558139537
04041134,04,04,11,34,5156,1937,4040,3219,821,1116,100.0,37.56788207913111,78.35531419705197,62.43211792086889,15.923196276183088,21.644685802948022
04041135,04,04,11,35,2739,899,2248,1840,408,491,100.0,32.82219788243885,82.07374954362906,67.17780211756116,14.895947426067908,17.926250456370937
04041136,04,04,11,36,3033,980,2470,2053,417,563,100.0,32.311242993735576,81.43752060666007,67.68875700626442,13.748763600395646,18.562479393339927
04041137,04,04,11,37,7976,2748,6477,5228,1249,1499,100.0,34.45336008024073,81.2061183550652,65.54663991975927,15.659478435305918,18.793881644934803
04041238,04,04,12,38,5907,1854,5005,4053,952,902,100.0,31.3864906043677,84.72998137802608,68.6135093956323,16.116471982393772,15.27001862197393
04041239,04,04,12,39,213,125,106,88,18,107,100.0,58.68544600938967,49.76525821596244,41.31455399061033,8.450704225352112,50.23474178403756
04041240,04,04,12,40,1533,392,1330,1141,189,203,100.0,25.570776255707763,86.7579908675799,74.42922374429224,12.32876712328767,13.24200913242009
04041241,04,04,12,41,6904,1578,6026,5326,700,878,100.0,22.856315179606028,87.2827346465817,77.14368482039397,10.139049826187717,12.717265353418309
04041342,04,04,13,42,4115,1279,3414,2836,578,701,100.0,31.081409477521266,82.9647630619684,68.91859052247874,14.046172539489671,17.03523693803159
04041343,04,04,13,43,3547,1043,2995,2504,491,552,100.0,29.405131096701435,84.43755286157317,70.59486890329856,13.842683958274598,15.56244713842684
04041344,04,04,13,44,10642,2757,8999,7885,1114,1643,100.0,25.906784439015222,84.56117271189626,74.09321556098479,10.467957150911483,15.43882728810374
04051445,04,05,14,45,6220,2550,4797,3670,1127,1423,100.0,40.9967845659164,77.12218649517685,59.0032154340836,18.118971061093248,22.877813504823152
04051446,04,05,14,46,10591,4384,8048,6207,1841,2543,100.0,41.39363610612784,75.98904730431498,58.60636389387216,17.38268341044283,24.010952695685013
04051447,04,05,14,47,5228,2057,3978,3171,807,1250,100.0,39.34583014537108,76.0902830910482,60.654169854628925,15.43611323641928,23.909716908951797
04051448,04,05,14,48,9067,4025,6512,5042,1470,2555,100.0,44.39175030329767,71.82088893790669,55.60824969670233,16.212639241204368,28.179111062093305
04051549,04,05,15,49,5348,2669,3336,2679,657,2012,100.0,49.90650710545999,62.378459237097985,50.09349289454001,12.284966342557965,37.621540762902015
04051550,04,05,15,50,5512,2098,4297,3414,883,1215,100.0,38.062409288824384,77.95718432510886,61.937590711175616,16.019593613933235,22.04281567489115
04051551,04,05,15,51,4397,1772,3385,2625,760,1012,100.0,40.30020468501251,76.98430748237435,59.69979531498749,17.284512167386854,23.015692517625656
04051652,04,05,16,52,9700,3604,7441,6096,1345,2259,100.0,37.15463917525773,76.71134020618557,62.84536082474227,13.8659793814433,23.288659793814436
04051653,04,05,16,53,6684,2605,5141,4079,1062,1543,100.0,38.9736684619988,76.91502094554158,61.0263315380012,15.888689407540395,23.084979054458408
04051654,04,05,16,54,3038,1060,2378,1978,400,660,100.0,34.89137590520079,78.275181040158,65.10862409479921,13.16655694535879,21.724818959842
04051655,04,05,16,55,7063,2957,5255,4106,1149,1808,100.0,41.86606257964038,74.40181226107886,58.133937420359615,16.26787484071924,25.59818773892114
04051656,04,05,16,56,7568,2322,6210,5246,964,1358,100.0,30.681818181818183,82.05602536997885,69.31818181818183,12.73784355179704,17.943974630021142
04061757,04,06,17,57,83,24,65,59,6,18,100.0,28.915662650602407,78.3132530120482,71.08433734939759,7.228915662650602,21.686746987951807
05010101,05,01,01,01,10883,3264,8979,7619,1360,1904,100.0,29.991730221446293,82.50482403748967,70.00826977855371,12.496554258935955,17.495175962510338
05010102,05,01,01,02,5885,1247,5171,4638,533,714,100.0,21.189464740866608,87.86745964316057,78.81053525913339,9.056924384027187,12.132540356839423
05010103,05,01,01,03,7623,1226,7064,6397,667,559,100.0,16.0829069919979,92.6669290305654,83.9170930080021,8.749836022563295,7.333070969434606
05010204,05,01,02,04,3297,1257,2704,2040,664,593,100.0,38.125568698817105,82.01395207764635,61.874431301182895,20.139520776463453,17.986047922353656
05010205,05,01,02,05,1910,518,1727,1392,335,183,100.0,27.12041884816754,90.41884816753927,72.87958115183247,17.539267015706805,9.581151832460733
05010206,05,01,02,06,10246,3518,8620,6728,1892,1626,100.0,34.33535038063635,84.13039234823346,65.66464961936366,18.465742728869802,15.869607651766543
05010207,05,01,02,07,11492,5616,9108,5876,3232,2384,100.0,48.86877828054298,79.25513400626522,51.13122171945701,28.123912286808217,20.74486599373477
05010208,05,01,02,08,7627,2367,6265,5260,1005,1362,100.0,31.03448275862069,82.14238888160482,68.96551724137932,13.176871640225515,17.857611118395177
05010209,05,01,02,09,6098,1737,5345,4361,984,753,100.0,28.48474909806494,87.65168907838635,71.51525090193506,16.136438176451296,12.348310921613644
05010310,05,01,03,10,3880,1268,3142,2612,530,738,100.0,32.68041237113402,80.97938144329898,67.31958762886599,13.65979381443299,19.02061855670103
05010311,05,01,03,11,5670,2905,4126,2765,1361,1544,100.0,51.23456790123457,72.7689594356261,48.76543209876543,24.00352733686067,27.2310405643739
05010312,05,01,03,12,7117,3631,4632,3486,1146,2485,100.0,51.01868764929043,65.08360264156245,48.981312350709565,16.10229029085289,34.91639735843754
05010313,05,01,03,13,6704,2550,5185,4154,1031,1519,100.0,38.036992840095465,77.34188544152745,61.963007159904535,15.378878281622912,22.658114558472555
05010314,05,01,03,14,11968,4296,9630,7672,1958,2338,100.0,35.89572192513369,80.46457219251337,64.1042780748663,16.360294117647058,19.53542780748663
05010339,05,01,03,39,974,641,395,333,62,579,100.0,65.81108829568788,40.55441478439425,34.18891170431211,6.365503080082135,59.445585215605746
05020415,05,02,04,15,3885,708,3698,3177,521,187,100.0,18.223938223938223,95.18661518661519,81.77606177606178,13.41055341055341,4.813384813384813
05020416,05,02,04,16,1709,95,1681,1614,67,28,100.0,5.558806319485079,98.36161497952018,94.44119368051493,3.920421299005266,1.638385020479813
05020417,05,02,04,17,5847,1600,5084,4247,837,763,100.0,27.364460407046348,86.95057294338977,72.63553959295365,14.31503335043612,13.049427056610227
05020418,05,02,04,18,4010,738,3667,3272,395,343,100.0,18.403990024937656,91.44638403990025,81.59600997506234,9.850374064837904,8.55361596009975
05020419,05,02,04,19,7032,1673,6218,5359,859,814,100.0,23.791240045506257,88.42434584755404,76.20875995449374,12.215585893060297,11.575654152445962
05020420,05,02,04,20,929,154,871,775,96,58,100.0,16.576964477933263,93.75672766415501,83.42303552206674,10.333692142088267,6.243272335844995
05020521,05,02,05,21,3095,815,2814,2280,534,281,100.0,26.33279483037157,90.92084006462035,73.66720516962843,17.253634894991922,9.079159935379645
05020522,05,02,05,22,7364,3166,5407,4198,1209,1957,100.0,42.992938620315044,73.42476914720261,57.007061379684956,16.417707767517655,26.575230852797393
05020523,05,02,05,23,12413,6700,9207,5713,3494,3206,100.0,53.97567066784822,74.17223878192218,46.02432933215177,28.147909449770403,25.82776121807782
05020524,05,02,05,24,6134,997,5709,5137,572,425,100.0,16.25366807955657,93.07140528203456,83.74633192044342,9.325073361591132,6.928594717965439
05020625,05,02,06,25,7482,2382,6172,5100,1072,1310,100.0,31.836407377706493,82.49131248329323,68.1635926222935,14.327719860999732,17.508687516706765
05020626,05,02,06,26,19359,6961,14723,12398,2325,4636,100.0,35.9574358179658,76.05248204969264,64.0425641820342,12.009917867658453,23.94751795030735
05020627,05,02,06,27,4059,1514,3247,2545,702,812,100.0,37.29982754372998,79.99507267799952,62.70017245627002,17.29490022172949,20.004927322000494
05020628,05,02,06,28,1984,425,1790,1559,231,194,100.0,21.421370967741936,90.22177419354838,78.57862903225806,11.643145161290322,9.778225806451612
05020629,05,02,06,29,4413,611,4108,3802,306,305,100.0,13.845456605483797,93.08860185814638,86.1545433945162,6.934058463630184,6.911398141853614
05030730,05,03,07,30,3938,2083,3275,1855,1420,663,100.0,52.89487049263586,83.16404266124935,47.10512950736415,36.05891315388522,16.835957338750635
05030731,05,03,07,31,11622,4693,9449,6929,2520,2173,100.0,40.380313199105146,81.30270177250043,59.619686800894854,21.683014971605576,18.69729822749957
05030832,05,03,08,32,11692,4926,8961,6766,2195,2731,100.0,42.13137187820732,76.64214847759152,57.868628121792675,18.773520355798837,23.357851522408485
05030833,05,03,08,33,1545,1249,407,296,111,1138,100.0,80.84142394822007,26.34304207119741,19.158576051779935,7.184466019417475,73.6569579288026
05040934,05,04,09,34,3965,1227,3056,2738,318,909,100.0,30.945775535939468,77.07440100882724,69.05422446406052,8.02017654476671,22.92559899117276
05040935,05,04,09,35,415,97,342,318,24,73,100.0,23.373493975903614,82.40963855421687,76.62650602409639,5.783132530120482,17.59036144578313
05040936,05,04,09,36,9855,1582,9314,8273,1041,541,100.0,16.052765093860984,94.51040081177068,83.94723490613902,10.56316590563166,5.489599188229325
05040937,05,04,09,37,2151,294,2033,1857,176,118,100.0,13.668061366806135,94.51417945141795,86.33193863319386,8.182240818224082,5.485820548582055
05040938,05,04,09,38,3670,480,3472,3190,282,198,100.0,13.079019073569482,94.60490463215258,86.92098092643052,7.68392370572207,5.395095367847412
06010101,06,01,01,01,6829,1562,5989,5267,722,840,100.0,22.87304144091375,87.69951676673013,77.12695855908625,10.57255820764387,12.300483233269878
06010102,06,01,01,02,8788,2961,7130,5827,1303,1658,100.0,33.69367319071461,81.13336367774238,66.3063268092854,14.827036868456986,18.866636322257623
06010103,06,01,01,03,6300,1867,5356,4433,923,944,100.0,29.634920634920636,85.01587301587301,70.36507936507937,14.65079365079365,14.984126984126982
06010204,06,01,02,04,6914,2199,5834,4715,1119,1080,100.0,31.80503326583743,84.37951981486839,68.19496673416256,16.184553080705815,15.620480185131616
06010205,06,01,02,05,9560,2727,8217,6833,1384,1343,100.0,28.52510460251046,85.9518828451883,71.47489539748953,14.476987447698745,14.048117154811715
06010206,06,01,02,06,7685,2059,6580,5626,954,1105,100.0,26.79245283018868,85.62134027325959,73.20754716981132,12.413793103448276,14.378659726740404
06010207,06,01,02,07,7771,2347,6543,5424,1119,1228,100.0,30.20203320036031,84.19765795907863,69.79796679963968,14.399691159438941,15.802342040921374
06010208,06,01,02,08,6798,2033,5676,4765,911,1122,100.0,29.905854663136218,83.49514563106796,70.09414533686379,13.401000294204177,16.50485436893204
06010209,06,01,02,09,9026,2712,7598,6314,1284,1428,100.0,30.04653224019499,84.17903833370264,69.95346775980501,14.225570573897627,15.820961666297364
06010210,06,01,02,10,4874,1256,4226,3618,608,648,100.0,25.7693885925318,86.70496512105046,74.23061140746819,12.474353713582273,13.295034878949528
06020301,06,02,03,01,4994,1014,4514,3980,534,480,100.0,20.304365238285943,90.38846615939127,79.69563476171405,10.692831397677214,9.61153384060873
06020302,06,02,03,02,5542,1215,4942,4327,615,600,100.0,21.923493323709852,89.17358354384699,78.07650667629015,11.097076867556838,10.826416456153014
06020303,06,02,03,03,7395,2017,6377,5378,999,1018,100.0,27.275185936443542,86.23394185260311,72.72481406355645,13.509127789046655,13.76605814739689
06020304,06,02,03,04,6744,1742,5864,5002,862,880,100.0,25.830367734282323,86.95136417556346,74.16963226571768,12.781731909845789,13.048635824436536
06020305,06,02,03,05,11433,3617,9497,7816,1681,1936,100.0,31.636490859791834,83.06656170733841,68.36350914020817,14.703052567130237,16.93343829266159
06020306,06,02,03,06,6450,1161,5975,5289,686,475,100.0,18.0,92.63565891472868,82.0,10.635658914728682,7.3643410852713185
06020407,06,02,04,07,4593,2157,3553,2436,1117,1040,100.0,46.96276943174396,77.35684737644242,53.03723056825604,24.31961680818637,22.64315262355759
06020408,06,02,04,08,6827,1735,5845,5092,753,982,100.0,25.413798154386992,85.61593672183976,74.586201845613,11.029734876226746,14.384063278160248
06020409,06,02,04,09,8200,1947,7114,6253,861,1086,100.0,23.74390243902439,86.7560975609756,76.2560975609756,10.5,13.24390243902439
06020410,06,02,04,10,7119,1261,6392,5858,534,727,100.0,17.713161960949574,89.78789155780305,82.28683803905042,7.501053518752634,10.212108442196937
06020411,06,02,04,11,8494,1862,7681,6632,1049,813,100.0,21.92135625147163,90.42853779138215,78.07864374852838,12.349894042853778,9.571462208617849
06030501,06,03,05,01,5898,1338,5017,4560,457,881,100.0,22.68565615462869,85.06273312987453,77.31434384537131,7.7483892845032205,14.937266870125466
06030502,06,03,05,02,5555,1196,4957,4359,598,598,100.0,21.530153015301533,89.23492349234924,78.46984698469846,10.765076507650766,10.765076507650766
06030503,06,03,05,03,11600,2958,10083,8642,1441,1517,100.0,25.5,86.92241379310344,74.5,12.422413793103448,13.077586206896552
06030504,06,03,05,04,11122,2293,9898,8829,1069,1224,100.0,20.616795540370436,88.99478511059162,79.38320445962957,9.611580650962056,11.00521488940838
06030605,06,03,06,05,6935,1777,5922,5158,764,1013,100.0,25.62364816149964,85.39293439077144,74.37635183850037,11.016582552271089,14.60706560922855
06030606,06,03,06,06,5223,1586,4335,3637,698,888,100.0,30.365690216350753,82.9982768523837,69.63430978364924,13.363967068734445,17.001723147616314
06030607,06,03,06,07,3020,1008,2349,2012,337,671,100.0,33.37748344370861,77.78145695364238,66.62251655629139,11.158940397350992,22.218543046357617
06030608,06,03,06,08,13113,3260,11570,9853,1717,1543,100.0,24.860825135361857,88.23305117059407,75.13917486463815,13.09387630595592,11.766948829405933
06030609,06,03,06,09,12047,2725,10555,9322,1233,1492,100.0,22.619739354196067,87.61517390221631,77.38026064580393,10.234913256412385,12.38482609778368
06030610,06,03,06,10,8103,1701,7170,6402,768,933,100.0,20.992225101814142,88.48574601999259,79.00777489818586,9.477971121806739,11.514253980007405
06040701,06,04,07,01,10113,2084,8931,8029,902,1182,100.0,20.607139325620487,88.31207356867398,79.3928606743795,8.919212894294471,11.687926431326016
06040702,06,04,07,02,5292,1004,4855,4288,567,437,100.0,18.972033257747544,91.74225245653818,81.02796674225246,10.714285714285714,8.25774754346183
06040703,06,04,07,03,10851,2748,8957,8103,854,1894,100.0,25.324854852087363,82.54538752188738,74.67514514791263,7.870242373974749,17.454612478112615
06040804,06,04,08,04,7585,1272,6918,6313,605,667,100.0,16.769940672379697,91.20632827949902,83.2300593276203,7.976268951878708,8.793671720500988
06040805,06,04,08,05,5405,1112,4834,4293,541,571,100.0,20.573543015726177,89.43570767807586,79.42645698427381,10.009250693802036,10.564292321924144
06040806,06,04,08,06,7299,1051,6755,6248,507,544,100.0,14.39923277161255,92.54692423619673,85.60076722838745,6.94615700780929,7.45307576380326
06040807,06,04,08,07,5770,1222,5121,4548,573,649,100.0,21.178509532062392,88.7521663778163,78.82149046793761,9.930675909878683,11.247833622183709
06040808,06,04,08,08,4592,1785,3799,2807,992,793,100.0,38.8719512195122,82.7308362369338,61.12804878048781,21.602787456445995,17.269163763066203
06040809,06,04,08,09,5136,1635,4033,3501,532,1103,100.0,31.83411214953271,78.52414330218068,68.16588785046729,10.358255451713395,21.475856697819314
06040810,06,04,08,10,7091,2000,5961,5091,870,1130,100.0,28.20476660555634,84.06430686786067,71.79523339444366,12.269073473417007,15.935693132139331
07010101,07,01,01,01,10130,4905,6988,5225,1763,3142,100.0,48.420533070088844,68.9832181638697,51.579466929911156,17.403751233958538,31.01678183613031
07010102,07,01,01,02,15907,8557,10694,7350,3344,5213,100.0,53.79392720186081,67.22826428616332,46.20607279813919,21.022191488024138,32.77173571383668
07010103,07,01,01,03,10257,3759,8004,6498,1506,2253,100.0,36.64814273179292,78.0345130155016,63.35185726820708,14.682655747294532,21.96548698449839
07010104,07,01,01,04,13701,7848,8848,5853,2995,4853,100.0,57.28049047514779,64.57922779359171,42.7195095248522,21.85971826873951,35.42077220640829
07020201,07,02,02,01,10496,3542,8554,6954,1600,1942,100.0,33.74618902439025,81.49771341463415,66.25381097560977,15.24390243902439,18.502286585365855
07020202,07,02,02,02,10237,4257,7668,5980,1688,2569,100.0,41.58444856891668,74.9047572531015,58.41555143108332,16.489205822018167,25.095242746898506
07020203,07,02,02,03,17768,7534,13329,10234,3095,4439,100.0,42.40207113912652,75.0168842863575,57.59792886087348,17.418955425484018,24.983115713642505
07020204,07,02,02,04,11779,4107,9312,7672,1640,2467,100.0,34.86713642923848,79.0559470243654,65.13286357076153,13.923083453603871,20.9440529756346
07030301,07,03,03,01,24695,6426,21132,18269,2863,3563,100.0,26.021461834379426,85.57197813322534,73.97853816562056,11.593439967604779,14.428021866774651
07030302,07,03,03,02,9351,2809,7872,6542,1330,1479,100.0,30.03956796064592,84.18350978504972,69.96043203935407,14.223077745695647,15.816490214950274
07030303,07,03,03,03,12334,5128,9722,7206,2516,2612,100.0,41.57613101994487,78.82276633695476,58.423868980055126,20.398897356899624,21.177233663045243
07040401,07,04,04,01,18419,7155,14462,11264,3198,3957,100.0,38.845757098648136,78.51674900917531,61.154242901351864,17.362506107823446,21.483250990824693
07040402,07,04,04,02,2293,453,2110,1840,270,183,100.0,19.755778456170955,92.01918883558656,80.24422154382904,11.774967291757523,7.980811164413431
07040403,07,04,04,03,23743,8251,19297,15492,3805,4446,100.0,34.75129511856126,81.27448089963357,65.24870488143874,16.025776018194836,18.725519100366427
07040404,07,04,04,04,5102,1225,4516,3877,639,586,100.0,24.01019208153665,88.51430811446491,75.98980791846334,12.524500196001567,11.485691885535084
07040405,07,04,04,05,11155,4616,8535,6539,1996,2620,100.0,41.38054683998207,76.51277454056476,58.61945316001793,17.89332138054684,23.487225459435233
07040406,07,04,04,06,3911,2012,2659,1899,760,1252,100.0,51.44464331373051,67.98772692406034,48.5553566862695,19.432370237790845,32.01227307593966
07050501,07,05,05,01,16062,6011,12957,10051,2906,3105,100.0,37.42373303449135,80.668658946582,62.57626696550865,18.09239198107334,19.331341053418004
07050502,07,05,05,02,8120,2887,6441,5233,1208,1679,100.0,35.55418719211823,79.32266009852216,64.44581280788178,14.876847290640393,20.677339901477833
07050503,07,05,05,03,9145,2697,7841,6448,1393,1304,100.0,29.491525423728817,85.74084199015856,70.50847457627118,15.23236741388737,14.259158009841444
07050504,07,05,05,04,5588,1689,4864,3899,965,724,100.0,30.22548317823908,87.0436649964209,69.77451682176091,17.269148174659986,12.956335003579097
07050505,07,05,05,05,10586,2755,9388,7831,1557,1198,100.0,26.024938598148502,88.68316644624976,73.9750614018515,14.708105044398263,11.316833553750236
07050506,07,05,05,06,2305,571,2035,1734,301,270,100.0,24.772234273318873,88.28633405639913,75.22776572668113,13.058568329718003,11.713665943600867
07060601,07,06,06,01,10109,3926,7985,6183,1802,2124,100.0,38.836680185972895,78.98901968542883,61.163319814027105,17.82569987140172,21.010980314571174
07060602,07,06,06,02,4638,997,4201,3641,560,437,100.0,21.496334626994393,90.57783527382493,78.5036653730056,12.074169900819319,9.422164726175076
07060603,07,06,06,03,3176,1318,2402,1858,544,774,100.0,41.49874055415617,75.62972292191435,58.501259445843836,17.12846347607053,24.370277078085643
07060604,07,06,06,04,14304,4994,12479,9310,3169,1825,100.0,34.913310961968676,87.24133109619687,65.08668903803132,22.154642058165546,12.758668903803134
07070701,07,07,07,01,10474,2017,9572,8457,1115,902,100.0,19.257208325377125,91.38819935077335,80.74279167462286,10.645407676150468,8.611800649226657
07070702,07,07,07,02,10801,1949,10078,8852,1226,723,100.0,18.044625497639107,93.30617535413388,81.95537450236088,11.350800851772984,6.693824645866124
07070703,07,07,07,03,7304,1637,6590,5667,923,714,100.0,22.41237677984666,90.22453450164294,77.58762322015335,12.636911281489594,9.775465498357065
07070704,07,07,07,04,8390,2952,6916,5438,1478,1474,100.0,35.18474374255066,82.43146603098927,64.81525625744935,17.61620977353993,17.568533969010726
07070705,07,07,07,05,6973,1079,6518,5894,624,455,100.0,15.473971031120035,93.47483149290119,84.52602896887996,8.948802524021225,6.525168507098809
07070706,07,07,07,06,3919,774,3420,3145,275,499,100.0,19.749936208216383,87.26715998979331,80.25006379178362,7.017096198009696,12.732840010206687
07070707,07,07,07,07,2936,452,2705,2484,221,231,100.0,15.39509536784741,92.13215258855585,84.60490463215258,7.5272479564032695,7.867847411444141
08010115,08,01,01,15,874,357,646,517,129,228,100.0,40.8466819221968,73.91304347826086,59.153318077803206,14.759725400457665,26.08695652173913
08010116,08,01,01,16,3576,1973,2289,1603,686,1287,100.0,55.17337807606264,64.01006711409396,44.82662192393736,19.1834451901566,35.98993288590604
08010117,08,01,01,17,15949,7815,10678,8134,2544,5271,100.0,48.99993730014421,66.95090601291616,51.00006269985579,15.950843313060382,33.04909398708383
08010118,08,01,01,18,11755,6902,7518,4853,2665,4237,100.0,58.715440238196514,63.955763504891536,41.284559761803486,22.671203743088046,36.044236495108464
08010211,08,01,02,11,9929,5725,6059,4204,1855,3870,100.0,57.65938160942693,61.02326518279787,42.34061839057307,18.682646792224798,38.976734817202136
08010212,08,01,02,12,7432,4917,4922,2515,2407,2510,100.0,66.15984930032293,66.22712594187298,33.840150699677075,32.38697524219591,33.772874058127016
08010213,08,01,02,13,12649,6726,8243,5923,2320,4406,100.0,53.17416396553087,65.16720689382561,46.82583603446913,18.34137085935647,34.83279310617441
08010214,08,01,02,14,8063,4445,5268,3618,1650,2795,100.0,55.128364132456895,65.33548307081732,44.8716358675431,20.463847203274216,34.66451692918269
08010301,08,01,03,01,27792,13202,19223,14590,4633,8569,100.0,47.502878526194586,69.16738629821532,52.49712147380541,16.6702648244099,30.832613701784684
08010302,08,01,03,02,3670,1278,2898,2392,506,772,100.0,34.822888283378745,78.96457765667574,65.17711171662125,13.787465940054497,21.03542234332425
08010303,08,01,03,03,8512,5123,5108,3389,1719,3404,100.0,60.18562030075187,60.00939849624061,39.81437969924812,20.195018796992482,39.9906015037594
08010404,08,01,04,04,23647,12428,15405,11219,4186,8242,100.0,52.556349642660805,65.1456844420011,47.443650357339195,17.702034084661904,34.8543155579989
08010405,08,01,04,05,9145,4254,6255,4891,1364,2890,100.0,46.517222525970475,68.39803171131766,53.48277747402952,14.915254237288137,31.601968288682343
08010406,08,01,04,06,7071,3996,4504,3075,1429,2567,100.0,56.51251591005515,63.69678970442653,43.48748408994484,20.209305614481686,36.30321029557347
08010407,08,01,04,07,835,354,592,481,111,243,100.0,42.39520958083832,70.89820359281437,57.60479041916168,13.293413173652693,29.101796407185628
08010508,08,01,05,08,5614,3914,3758,1700,2058,1856,100.0,69.71856074100464,66.9397933737086,30.28143925899537,36.65835411471321,33.06020662629142
08010509,08,01,05,09,9489,6132,6711,3357,3354,2778,100.0,64.62219411950679,70.72399620613342,35.3778058804932,35.346190325640215,29.276003793866582
08010510,08,01,05,10,502,345,236,157,79,266,100.0,68.72509960159363,47.01195219123506,31.274900398406373,15.737051792828685,52.98804780876494
08020619,08,02,06,19,10947,5749,7562,5198,2364,3385,100.0,52.516671234128076,69.07828628848087,47.48332876587193,21.594957522608933,30.92171371151914
08020620,08,02,06,20,9286,3885,7382,5401,1981,1904,100.0,41.83717424079259,79.49601550721516,58.1628257592074,21.333189748007754,20.503984492784838
08020621,08,02,06,21,2322,575,2121,1747,374,201,100.0,24.763135228251507,91.343669250646,75.23686477174849,16.1068044788975,8.656330749354005
08020622,08,02,06,22,14255,3730,12492,10525,1967,1763,100.0,26.166257453525077,87.63240968081375,73.83374254647492,13.79866713433883,12.36759031918625
08020623,08,02,06,23,1289,352,1131,937,194,158,100.0,27.307990690457718,87.74243599689682,72.69200930954229,15.050426687354538,12.25756400310318
08020624,08,02,06,24,1265,398,1112,867,245,153,100.0,31.46245059288538,87.90513833992095,68.53754940711462,19.367588932806324,12.09486166007905
08020625,08,02,06,25,3337,895,2883,2442,441,454,100.0,26.820497452801916,86.39496553790829,73.17950254719808,13.21546299071022,13.6050344620917
08020726,08,02,07,26,8344,1907,7528,6437,1091,816,100.0,22.854745925215724,90.22051773729626,77.14525407478428,13.075263662511984,9.77948226270374
08020727,08,02,07,27,11651,3003,10408,8648,1760,1243,100.0,25.77461162132006,89.33138786370269,74.22538837867995,15.105999485022744,10.668612136297313
08020728,08,02,07,28,8444,3206,6832,5238,1594,1612,100.0,37.96778777830412,80.90952155376598,62.03221222169588,18.87730933207011,19.090478446234012
08030829,08,03,08,29,12454,5994,10020,6460,3560,2434,100.0,48.129115143728924,80.4560783683957,51.87088485627108,28.58519351212462,19.543921631604306
08030830,08,03,08,30,7321,2771,6259,4550,1709,1062,100.0,37.85002048900423,85.49378500204891,62.14997951099577,23.343805491053136,14.5062149979511
08030831,08,03,08,31,17099,8244,13732,8855,4877,3367,100.0,48.21334580969647,80.30878998771857,51.78665419030353,28.522135797415054,19.69121001228142
08040932,08,04,09,32,2879,842,2537,2037,500,342,100.0,29.246266064605763,88.12087530392498,70.75373393539424,17.36714136853074,11.879124696075026
08040933,08,04,09,33,4129,1211,3620,2918,702,509,100.0,29.329135383870188,87.67255994187455,70.67086461612982,17.00169532574473,12.327440058125454
08040934,08,04,09,34,2688,790,2373,1898,475,315,100.0,29.389880952380953,88.28125,70.61011904761905,17.671130952380953,11.71875
08041035,08,04,10,35,8103,2355,7149,5748,1401,954,100.0,29.063309885227696,88.22658274713069,70.9366901147723,17.289892632358388,11.773417252869308
08041036,08,04,10,36,6765,1369,6238,5396,842,527,100.0,20.23651145602365,92.209903917221,79.76348854397635,12.446415373244642,7.79009608277901
08041037,08,04,10,37,9682,2175,8701,7507,1194,981,100.0,22.464366866349927,89.86779590993596,77.53563313365007,12.332162776285891,10.132204090064038
08041038,08,04,10,38,6913,1456,6417,5457,960,496,100.0,21.061767684073484,92.82511210762333,78.93823231592651,13.886879791696801,7.174887892376682
08041039,08,04,10,39,3858,1095,3493,2763,730,365,100.0,28.38258164852255,90.53913945049248,71.61741835147744,18.921721099015034,9.460860549507517
08041040,08,04,10,40,7987,1733,7323,6254,1069,664,100.0,21.697758858144482,91.6864905471391,78.30224114185552,13.384249405283585,8.313509452860899
09010101,09,01,01,01,11934,3376,9827,8558,1269,2107,100.0,28.288922406569466,82.34456175632646,71.71107759343055,10.633484162895927,17.655438243673537
09010102,09,01,01,02,70,12,61,58,3,9,100.0,17.142857142857142,87.14285714285714,82.85714285714286,4.285714285714286,12.857142857142856
09010201,09,01,02,01,4319,654,3980,3665,315,339,100.0,15.142394072702015,92.1509608705719,84.85760592729798,7.293354943273905,7.849039129428108
09010202,09,01,02,02,6823,838,6284,5985,299,539,100.0,12.281987395573795,92.1002491572622,87.7180126044262,4.382236552835996,7.899750842737799
09010301,09,01,03,01,15387,1909,14264,13478,786,1123,100.0,12.406576980568012,92.70163124715668,87.593423019432,5.1082082277247025,7.298368752843309
09010302,09,01,03,02,2906,583,2655,2323,332,251,100.0,20.06194081211287,91.36269786648313,79.93805918788713,11.424638678596008,8.637302133516862
09010401,09,01,04,01,8203,587,7876,7616,260,327,100.0,7.155918566378154,96.0136535413873,92.84408143362185,3.1695721077654517,3.986346458612703
09010402,09,01,04,02,11480,1817,10346,9663,683,1134,100.0,15.827526132404182,90.1219512195122,84.17247386759583,5.949477351916376,9.878048780487806
09020501,09,02,05,01,6683,1619,5465,5064,401,1218,100.0,24.225647164447103,81.77465210234925,75.77435283555289,6.000299266796349,18.225347897650757
09020502,09,02,05,02,14865,2428,13254,12437,817,1611,100.0,16.333669693911872,89.16246215943492,83.66633030608813,5.496131853346788,10.837537840565085
09020601,09,02,06,01,7658,1449,6587,6209,378,1071,100.0,18.921389396709323,86.0146252285192,81.07861060329068,4.93601462522852,13.985374771480805
09020602,09,02,06,02,3512,187,3420,3325,95,92,100.0,5.324601366742597,97.38041002277905,94.6753986332574,2.70501138952164,2.619589977220957
09020701,09,02,07,01,1259,631,703,628,75,556,100.0,50.11914217633042,55.83796664019063,49.88085782366958,5.957108816521049,44.16203335980937
09020702,09,02,07,02,16091,1922,14755,14169,586,1336,100.0,11.944565284941893,91.69722204959294,88.05543471505811,3.641787334534833,8.30277795040706
09020801,09,02,08,01,2935,198,2822,2737,85,113,100.0,6.746166950596252,96.14991482112436,93.25383304940374,2.8960817717206133,3.8500851788756387
09020802,09,02,08,02,7737,1183,6913,6554,359,824,100.0,15.29016414630994,89.3498772133902,84.70983585369007,4.640041359700142,10.650122786609797
09030901,09,03,09,01,12998,1571,12201,11427,774,797,100.0,12.086474842283428,93.8682874288352,87.91352515771658,5.954762271118633,6.131712571164795
09030902,09,03,09,02,5667,649,5355,5018,337,312,100.0,11.452267513675666,94.49444150344097,88.54773248632434,5.94670901711664,5.505558496559026
09030903,09,03,09,03,8063,1283,7480,6780,700,583,100.0,15.912191492000497,92.76944065484311,84.08780850799951,8.681632146843606,7.230559345156889
09031001,09,03,10,01,12776,1333,11911,11443,468,865,100.0,10.433625547902317,93.22949279899812,89.56637445209769,3.663118346900438,6.7705072010018785
09031101,09,03,11,01,6041,670,5546,5371,175,495,100.0,11.090878993544115,91.80599238536666,88.90912100645588,2.8968713789107765,8.194007614633339
09031201,09,03,12,01,1799,137,1736,1662,74,63,100.0,7.615341856586992,96.49805447470817,92.384658143413,4.113396331295164,3.501945525291829
09031202,09,03,12,02,2475,196,2356,2279,77,119,100.0,7.919191919191919,95.1919191919192,92.08080808080808,3.111111111111111,4.808080808080808
09041301,09,04,13,01,14437,1080,13702,13357,345,735,100.0,7.480778555101475,94.90891459444482,92.51922144489852,2.3896931495463045,5.09108540555517
09041302,09,04,13,02,1812,146,1748,1666,82,64,100.0,8.057395143487858,96.46799116997794,91.94260485651215,4.525386313465784,3.532008830022075
09041401,09,04,14,01,4962,559,4527,4403,124,435,100.0,11.265618702136235,91.23337363966144,88.73438129786376,2.4989923417976625,8.766626360338574
09041402,09,04,14,02,1485,145,1438,1340,98,47,100.0,9.764309764309765,96.83501683501684,90.23569023569024,6.5993265993265995,3.1649831649831652
09041501,09,04,15,01,7382,944,6834,6438,396,548,100.0,12.787862367921973,92.57653752370632,87.21213763207803,5.364399891628286,7.423462476293688
09041601,09,04,16,01,6582,362,6430,6220,210,152,100.0,5.499848070495291,97.69067152841082,94.50015192950471,3.1905195989061075,2.3093284715891826
09051701,09,05,17,01,3583,226,3425,3357,68,158,100.0,6.307563494278537,95.59028746860173,93.69243650572146,1.8978509628802678,4.409712531398269
09051702,09,05,17,02,14685,858,14222,13827,395,463,100.0,5.842696629213483,96.84712291453864,94.15730337078652,2.6898195437521277,3.152877085461355
09051801,09,05,18,01,9393,806,8868,8587,281,525,100.0,8.58085808580858,94.41073139572022,91.41914191419141,2.991589481528798,5.589268604279782
09051901,09,05,19,01,10747,923,10180,9824,356,567,100.0,8.588443286498558,94.7241090536894,91.41155671350144,3.3125523401879597,5.275890946310598
09052001,09,05,20,01,12775,729,12372,12046,326,403,100.0,5.706457925636007,96.8454011741683,94.29354207436398,2.551859099804305,3.1545988258317026
10010101,10,01,01,01,5671,1418,4968,4253,715,703,100.0,25.00440839358138,87.6035972491624,74.99559160641863,12.608005642743784,12.396402750837595
10010102,10,01,01,02,17831,3954,16237,13877,2360,1594,100.0,22.174864000897312,91.0605125904324,77.82513599910268,13.235376591329706,8.939487409567606
10010203,10,01,02,03,1379,977,457,402,55,922,100.0,70.84844089920233,33.139956490210295,29.15155910079768,3.9883973894126177,66.8600435097897
10010204,10,01,02,04,10479,2167,9595,8312,1283,884,100.0,20.679454146388014,91.56408054203645,79.32054585361199,12.243534688424468,8.435919457963546
10010205,10,01,02,05,8319,1268,7591,7051,540,728,100.0,15.242216612573625,91.24894819088833,84.75778338742637,6.491164803461954,8.751051809111672
10010206,10,01,02,06,17015,3412,15161,13603,1558,1854,100.0,20.052894504848663,89.10373200117543,79.94710549515133,9.156626506024097,10.896267998824566
10010207,10,01,02,07,10762,2288,9759,8474,1285,1003,100.0,21.259988849656196,90.6801709719383,78.7400111503438,11.9401598215945,9.319829028061699
10010308,10,01,03,08,2329,691,1832,1638,194,497,100.0,29.669386002576214,78.66036925719193,70.33061399742378,8.329755259768142,21.339630742808072
10010309,10,01,03,09,14378,2787,13289,11591,1698,1089,100.0,19.383780776185837,92.42592850187788,80.61621922381416,11.809709278063709,7.574071498122131
10010310,10,01,03,10,17818,3159,16502,14659,1843,1316,100.0,17.72926254349534,92.6142103490852,82.27073745650466,10.343472892580536,7.385789650914805
10010311,10,01,03,11,2932,352,2845,2580,265,87,100.0,12.005457025920874,97.03274215552524,87.99454297407912,9.038199181446112,2.9672578444747613
10020412,10,02,04,12,6736,1773,5873,4963,910,863,100.0,26.321258907363422,87.18824228028504,73.67874109263659,13.509501187648457,12.811757719714963
10020413,10,02,04,13,15530,2550,14020,12980,1040,1510,100.0,16.419832582099165,90.27688345138442,83.58016741790084,6.69671603348358,9.723116548615582
10020414,10,02,04,14,1660,640,1455,1020,435,205,100.0,38.55421686746988,87.65060240963855,61.44578313253012,26.20481927710843,12.349397590361445
10020415,10,02,04,15,5550,1321,4615,4229,386,935,100.0,23.8018018018018,83.15315315315316,76.1981981981982,6.954954954954955,16.846846846846848
10020416,10,02,04,16,5547,1322,4706,4225,481,841,100.0,23.83270236163692,84.83865152334596,76.16729763836307,8.671353884982874,15.161348476654046
10020517,10,02,05,17,8861,779,8514,8082,432,347,100.0,8.79133280668096,96.08396343527818,91.20866719331903,4.875296241959147,3.916036564721815
10020518,10,02,05,18,5167,727,4724,4440,284,443,100.0,14.070059996129283,91.42635958970389,85.92994000387073,5.496419585833172,8.57364041029611
10020519,10,02,05,19,6051,1704,4784,4347,437,1267,100.0,28.16063460585027,79.06131217980499,71.83936539414972,7.221946785655263,20.93868782019501
10020620,10,02,06,20,3299,429,3114,2870,244,185,100.0,13.003940588056986,94.39224007274932,86.99605941194302,7.396180660806305,5.607759927250682
10020621,10,02,06,21,6071,835,5623,5236,387,448,100.0,13.753912040849942,92.62065557568769,86.24608795915006,6.374567616537638,7.379344424312305
10020622,10,02,06,22,8631,976,8206,7655,551,425,100.0,11.308075541652183,95.07588923647317,88.69192445834781,6.383964778125362,4.924110763526822
10020623,10,02,06,23,6527,642,6293,5885,408,234,100.0,9.836065573770492,96.41489198713037,90.1639344262295,6.250957560900873,3.5851080128696187
10030724,10,03,07,24,7799,1143,7015,6656,359,784,100.0,14.655725092960637,89.9474291575843,85.34427490703936,4.603154250544941,10.052570842415694
10030725,10,03,07,25,6297,1157,5529,5140,389,768,100.0,18.37382880736859,87.80371605526442,81.62617119263142,6.177544862633,12.196283944735589
10030726,10,03,07,26,3009,291,2885,2718,167,124,100.0,9.67098703888335,95.87902957793287,90.32901296111665,5.550016616816218,4.120970422067132
10030727,10,03,07,27,9315,795,9026,8520,506,289,100.0,8.53462157809984,96.89747718733226,91.46537842190016,5.432098765432099,3.10252281266774
10040828,10,04,08,28,7719,521,7479,7198,281,240,100.0,6.749578961005312,96.89078896230082,93.25042103899469,3.640367923306128,3.109211037699184
10040829,10,04,08,29,3762,297,3573,3465,108,189,100.0,7.894736842105263,94.97607655502392,92.10526315789474,2.8708133971291865,5.023923444976076
10040830,10,04,08,30,7545,402,7393,7143,250,152,100.0,5.328031809145129,97.98542080848243,94.67196819085487,3.313452617627568,2.0145791915175613
10040931,10,04,09,31,9323,579,9093,8744,349,230,100.0,6.210447280918159,97.53298294540384,93.78955271908184,3.743430226321999,2.46701705459616
10040932,10,04,09,32,3956,324,3788,3632,156,168,100.0,8.190091001011123,95.75328614762387,91.80990899898887,3.9433771486349847,4.246713852376137
10040933,10,04,09,33,14747,786,14396,13961,435,351,100.0,5.329897606292806,97.61985488573947,94.6701023937072,2.9497524920322777,2.3801451142605274
11010101,11,01,01,01,592,57,559,535,24,33,100.0,9.628378378378379,94.42567567567568,90.37162162162163,4.054054054054054,5.574324324324325
11010102,11,01,01,02,2557,117,2512,2440,72,45,100.0,4.575674618693782,98.24012514665624,95.42432538130622,2.8157997653500195,1.759874853343762
11010103,11,01,01,03,1604,406,1276,1198,78,328,100.0,25.311720698254366,79.55112219451371,74.68827930174564,4.86284289276808,20.448877805486283
11010204,11,01,02,04,8907,2340,7637,6567,1070,1270,100.0,26.271471876052544,85.74155158863816,73.72852812394746,12.013023464690693,14.25844841136185
11010205,11,01,02,05,6713,1657,5903,5056,847,810,100.0,24.683450022344704,87.93385967525697,75.3165499776553,12.61730969760167,12.066140324743035
11010206,11,01,02,06,5997,1115,5361,4882,479,636,100.0,18.592629648157413,89.39469734867433,81.40737035184259,7.987326996831749,10.605302651325662
11010207,11,01,02,07,7113,1209,6435,5904,531,678,100.0,16.997047659215518,90.46815689582455,83.00295234078447,7.465204555040067,9.531843104175454
11010308,11,01,03,08,11771,2958,10176,8813,1363,1595,100.0,25.12955568770708,86.44974938407952,74.87044431229293,11.579305071786594,13.550250615920485
11010309,11,01,03,09,9670,2206,8376,7464,912,1294,100.0,22.81282316442606,86.61840744570839,77.18717683557395,9.431230610134437,13.381592554291624
11010310,11,01,03,10,5238,533,4975,4705,270,263,100.0,10.175639557082857,94.97899961817488,89.82436044291714,5.154639175257731,5.021000381825124
11020411,11,02,04,11,9242,2090,7731,7152,579,1511,100.0,22.61415278078338,83.65072495130924,77.38584721921661,6.2648777320926206,16.34927504869076
11020412,11,02,04,12,6410,1081,5785,5329,456,625,100.0,16.86427457098284,90.24960998439937,83.13572542901716,7.1138845553822145,9.750390015600624
11020513,11,02,05,13,4014,764,3389,3250,139,625,100.0,19.0333831589437,84.42949676133532,80.96661684105631,3.4628799202790232,15.570503238664674
11020514,11,02,05,14,9074,1620,7828,7454,374,1246,100.0,17.853206964954815,86.2684593343619,82.14679303504518,4.121666299316729,13.731540665638086
11020515,11,02,05,15,14529,3120,12747,11409,1338,1782,100.0,21.4742927937229,87.73487507743134,78.52570720627709,9.209167871154243,12.265124922568656
11020516,11,02,05,16,3725,362,3569,3363,206,156,100.0,9.718120805369129,95.81208053691275,90.28187919463087,5.530201342281879,4.1879194630872485
11030617,11,03,06,17,6044,1725,4990,4319,671,1054,100.0,28.540701522170746,82.56121773659828,71.45929847782925,11.101919258769028,17.43878226340172
11030618,11,03,06,18,15954,3574,13894,12380,1514,2060,100.0,22.40190547824997,87.08787764823869,77.59809452175003,9.489783126488655,12.912122351761312
11030619,11,03,06,19,10784,2925,9114,7859,1255,1670,100.0,27.123516320474778,84.51409495548961,72.87648367952522,11.637611275964392,15.485905044510387
11030720,11,03,07,20,5858,3715,2431,2143,288,3427,100.0,63.417548651416865,41.49880505291909,36.582451348583135,4.916353704335951,58.50119494708091
11030721,11,03,07,21,25327,6642,20339,18685,1654,4988,100.0,26.22497729695582,80.3056027164686,73.77502270304419,6.530580013424409,19.69439728353141
11030824,11,03,08,24,10019,3141,8162,6878,1284,1857,100.0,31.35043417506737,81.46521608943009,68.64956582493262,12.815650264497455,18.534783910569917
11040925,11,04,09,25,3817,730,3348,3087,261,469,100.0,19.124967251768403,87.7128635053707,80.87503274823159,6.837830757139114,12.28713649462929
11040926,11,04,09,26,28022,5045,24703,22977,1726,3319,100.0,18.003711369638143,88.15573477981586,81.99628863036186,6.159446149454,11.844265220184141
11041022,11,04,10,22,5448,1652,4292,3796,496,1156,100.0,30.323054331864906,78.78120411160059,69.67694566813509,9.104258443465492,21.218795888399413
11041023,11,04,10,23,5980,1718,5032,4262,770,948,100.0,28.729096989966557,84.14715719063544,71.27090301003345,12.876254180602006,15.852842809364548
11041027,11,04,10,27,3033,877,2402,2156,246,631,100.0,28.915265413781732,79.19551599076821,71.08473458621827,8.11078140454995,20.804484009231782
11041128,11,04,11,28,25108,4922,22178,20186,1992,2930,100.0,19.603313684881314,88.33041261749244,80.3966863151187,7.933726302373745,11.669587382507569
11051229,11,05,12,29,3494,498,3257,2996,261,237,100.0,14.253005151688608,93.21694333142531,85.74699484831139,7.46994848311391,6.7830566685747
11051330,11,05,13,30,9336,1553,8226,7783,443,1110,100.0,16.634532990574122,88.11053984575835,83.36546700942587,4.745072836332477,11.889460154241645
11051331,11,05,13,31,11073,1951,9579,9122,457,1494,100.0,17.619434660886842,86.5077214846925,82.38056533911316,4.127156145579337,13.492278515307504
11051332,11,05,13,32,6668,676,6360,5992,368,308,100.0,10.137972405518896,95.38092381523695,89.8620275944811,5.518896220755849,4.619076184763047
12103115,12,10,31,15,7568,2962,5907,4606,1301,1661,100.0,39.1384778012685,78.05232558139535,60.8615221987315,17.190803382663848,21.947674418604652
12103116,12,10,31,16,9479,4128,7120,5351,1769,2359,100.0,43.548897563034075,75.11340858740373,56.451102436965925,18.66230615043781,24.886591412596264
12103117,12,10,31,17,10672,5284,7469,5388,2081,3203,100.0,49.51274362818591,69.9868815592204,50.48725637181409,19.4996251874063,30.013118440779614
12103218,12,10,32,18,13515,5406,10577,8109,2468,2938,100.0,40.0,78.26119126896042,60.0,18.261191268960413,21.738808731039587
12103219,12,10,32,19,8803,3557,6863,5246,1617,1940,100.0,40.40667954106554,77.9620583891855,59.59332045893445,18.36873793025105,22.037941610814496
12103220,12,10,32,20,4601,1167,4029,3434,595,572,100.0,25.364051293197132,87.56792001738752,74.63594870680286,12.931971310584656,12.432079982612477
12214125,12,21,41,25,7315,1939,6292,5376,916,1023,100.0,26.507177033492823,86.01503759398497,73.49282296650718,12.522214627477785,13.984962406015036
12214126,12,21,41,26,7651,2525,6494,5126,1368,1157,100.0,33.002221931773626,84.87779375245066,66.99777806822638,17.880015684224286,15.122206247549341
12214421,12,21,44,21,2598,842,2130,1756,374,468,100.0,32.409545804464976,81.98614318706697,67.59045419553503,14.395688991531946,18.013856812933028
12214422,12,21,44,22,7955,4389,5551,3566,1985,2404,100.0,55.172847265870516,69.78001257071026,44.82715273412948,24.952859836580767,30.21998742928976
12214423,12,21,44,23,5517,1995,4583,3522,1061,934,100.0,36.16095704187058,83.0705093347834,63.83904295812942,19.231466376653977,16.929490665216605
12214424,12,21,44,24,10663,5052,7588,5611,1977,3075,100.0,47.37878645784488,71.16196192441151,52.62121354215512,18.5407483822564,28.838038075588486
12214527,12,21,45,27,10698,2015,9611,8683,928,1087,100.0,18.83529631706861,89.83922228453916,81.16470368293139,8.674518601607776,10.160777715460833
12214528,12,21,45,28,252,78,211,174,37,41,100.0,30.952380952380953,83.73015873015873,69.04761904761905,14.682539682539684,16.26984126984127
12224229,12,22,42,29,6081,797,5745,5284,461,336,100.0,13.106396974181877,94.47459299457326,86.89360302581812,7.580989968755139,5.5254070054267395
12224230,12,22,42,30,18043,2157,17106,15886,1220,937,100.0,11.954774704871696,94.8068503020562,88.0452252951283,6.761625006927894,5.193149697943801
12231101,12,23,11,01,16532,1956,15609,14576,1033,923,100.0,11.83159932252601,94.41688845874667,88.168400677474,6.248487781272683,5.583111541253327
12231102,12,23,11,02,16886,1919,16095,14967,1128,791,100.0,11.364443918038612,95.31564609735877,88.63555608196138,6.68009001539737,4.684353902641241
12301203,12,30,12,03,15270,4415,12431,10855,1576,2839,100.0,28.912901113294044,81.40798952193845,71.08709888670596,10.320890635232482,18.592010478061557
12301204,12,30,12,04,6561,1678,5552,4883,669,1009,100.0,25.57536960829142,84.62124676116446,74.42463039170858,10.196616369455876,15.378753238835543
12301205,12,30,12,05,4924,845,4541,4079,462,383,100.0,17.1608448415922,92.22177091795288,82.83915515840779,9.382615759545084,7.778229082047117
12301206,12,30,12,06,5120,774,4860,4346,514,260,100.0,15.117187500000002,94.921875,84.8828125,10.0390625,5.078125
12302107,12,30,21,07,3054,1150,2572,1904,668,482,100.0,37.65553372626064,84.21741977734119,62.344466273739364,21.872953503601835,15.782580222658806
12302108,12,30,21,08,14505,5881,11726,8624,3102,2779,100.0,40.54463977938642,80.84108927955877,59.455360220613585,21.38572905894519,19.158910720441227
12302109,12,30,21,09,11666,5780,8764,5886,2878,2902,100.0,49.545688325047145,75.12429281673238,50.454311674952855,24.66998114177953,24.875707183267615
12302110,12,30,21,10,10481,5503,7725,4978,2747,2756,100.0,52.50453201030436,73.70479916038546,47.49546798969564,26.209331170689822,26.29520083961454
12302211,12,30,22,11,3301,830,2954,2471,483,347,100.0,25.1438957891548,89.48803392911239,74.8561042108452,14.631929718267193,10.51196607088761
12302212,12,30,22,12,5929,2559,4368,3370,998,1561,100.0,43.160735368527575,73.67178276269185,56.83926463147242,16.83251813121943,26.32821723730815
12304313,12,30,43,13,6619,1333,5823,5286,537,796,100.0,20.138993805710832,87.97401420154102,79.86100619428916,8.113008007251851,12.025985798458983
12304314,12,30,43,14,9660,1230,9097,8430,667,563,100.0,12.732919254658384,94.17184265010351,87.26708074534162,6.904761904761905,5.828157349896481
