id,district_id,forecast_area_id,district_region_id,planning_area_id,inhabitants,inhabitants_with_migration_background,inhabitants_germans,inhabitants_germans_without_migration_background,inhabitants_germans_with_migration_background,inhabitants_foreigners,inhabitants_percentage,inhabitants_with_migration_background_percentage,inhabitants_germans_percentage,inhabitants_germans_without_migration_background_percentage,inhabitants_germans_with_migration_background_percentage,inhabitants_foreigners_percentage
01011101,01,01,11,01,3419,2049,2032,1370,662,1387,100.0,59.92980403626792,59.43258262649898,40.07019596373208,19.36238666276689,40.56741737350102
01011102,01,01,11,02,192,90,119,102,17,73,100.0,46.875,61.979166666666664,53.125,8.854166666666668,38.02083333333333
01011103,01,01,11,03,5211,3041,3358,2170,1188,1853,100.0,58.35732105162157,64.44060640951832,41.64267894837843,22.797927461139896,35.559393590481676
01011104,01,01,11,04,4636,2994,2849,1642,1207,1787,100.0,64.58153580672995,61.45383951682485,35.41846419327006,26.03537532355479,38.54616048317515
01011105,01,01,11,05,1599,1109,763,490,273,836,100.0,69.3558474046279,47.71732332707943,30.64415259537211,17.073170731707318,52.28267667292058
01011201,01,01,12,01,2573,1593,1439,980,459,1134,100.0,61.912164788184995,55.926933540614066,38.087835211815005,17.839098328799068,44.07306645938593
01011202,01,01,12,02,646,316,418,330,88,228,100.0,48.91640866873065,64.70588235294117,51.08359133126935,13.622291021671826,35.294117647058826
01011203,01,01,12,03,1157,630,732,527,205,425,100.0,54.451166810717375,63.267070008643046,45.548833189282625,17.718236819360413,36.732929991356954
01011204,01,01,12,04,8312,4291,5498,4021,1477,2814,100.0,51.62415784408084,66.14533205004813,48.37584215591915,17.76948989412897,33.854667949951875
01011301,01,01,13,01,6967,3077,4814,3890,924,2153,100.0,44.1653509401464,69.09717238409645,55.83464905985359,13.262523324242858,30.902827615903544
01011302,01,01,13,02,12352,5060,9044,7292,1752,3308,100.0,40.965025906735754,73.21891191709845,59.034974093264246,14.183937823834198,26.781088082901555
01011303,01,01,13,03,9903,4845,6433,5058,1375,3470,100.0,48.92456831263254,64.9601130970413,51.07543168736747,13.884681409673835,35.0398869029587
01011304,01,01,13,04,9013,4134,6357,4879,1478,2656,100.0,45.867080883168754,70.53145456562743,54.132919116831246,16.398535448796185,29.468545434372572
01011305,01,01,13,05,9422,4188,6657,5234,1423,2765,100.0,44.4491615368287,70.65378900445765,55.5508384631713,15.10295054128635,29.34621099554235
01011306,01,01,13,06,10779,4967,7432,5812,1620,3347,100.0,46.08034140458299,68.9488820855367,53.91965859541702,15.029223490119678,31.051117914463312
01011401,01,01,14,01,17771,7829,12333,9942,2391,5438,100.0,44.05492093860784,69.39958359124417,55.94507906139216,13.454504529852008,30.600416408755837
01011402,01,01,14,02,13443,5433,9824,8010,1814,3619,100.0,40.4150859183218,73.07892583500707,59.5849140816782,13.494011753328868,26.92107416499293
01022101,01,02,21,01,3450,1929,2151,1521,630,1299,100.0,55.913043478260875,62.34782608695652,44.086956521739125,18.26086956521739,37.65217391304348
01022102,01,02,21,02,6866,4318,3879,2548,1331,2987,100.0,62.88960093212933,56.4957762889601,37.11039906787067,19.385377221089424,43.504223711039906
01022103,01,02,21,03,275,218,101,57,44,174,100.0,79.27272727272727,36.72727272727273,20.727272727272727,16.0,63.272727272727266
01022104,01,02,21,04,18536,9423,12473,9113,3360,6063,100.0,50.83621061717738,67.29067760034528,49.163789382822614,18.12688821752266,32.70932239965473
01022105,01,02,21,05,5235,3087,3315,2148,1167,1920,100.0,58.96848137535816,63.323782234957015,41.03151862464183,22.292263610315185,36.67621776504298
01022106,01,02,21,06,11333,4035,9066,7298,1768,2267,100.0,35.603988352598606,79.99647048442601,64.3960116474014,15.60045883702462,20.003529515573987
01022201,01,02,22,01,10825,5466,7505,5359,2146,3320,100.0,50.49422632794457,69.33025404157044,49.505773672055426,19.824480369515012,30.669745958429562
01022202,01,02,22,02,5178,3486,2838,1692,1146,2340,100.0,67.32329084588645,54.80880648899189,32.67670915411356,22.13209733487833,45.19119351100811
01022203,01,02,22,03,6976,4169,4602,2807,1795,2374,100.0,59.762041284403665,65.9690366972477,40.23795871559633,25.731077981651374,34.03096330275229
01022204,01,02,22,04,5935,2546,4408,3389,1019,1527,100.0,42.89806234203875,74.27127211457456,57.101937657961244,17.16933445661331,25.72872788542544
01022205,01,02,22,05,3280,2125,2190,1155,1035,1090,100.0,64.78658536585365,66.76829268292683,35.21341463414634,31.554878048780488,33.23170731707317
01022206,01,02,22,06,3132,1328,2419,1804,615,713,100.0,42.40102171136654,77.23499361430396,57.59897828863346,19.6360153256705,22.76500638569604
01022207,01,02,22,07,5807,2781,3829,3026,803,1978,100.0,47.89047701050456,65.93766144308593,52.10952298949544,13.828138453590494,34.06233855691407
01033101,01,03,31,01,26381,16815,15536,9566,5970,10845,100.0,63.739054622645085,58.890868428035326,36.260945377354915,22.629923050680414,41.10913157196467
01033102,01,03,31,02,11665,7224,7246,4441,2805,4419,100.0,61.92884697813973,62.11744534933562,38.07115302186027,24.046292327475356,37.88255465066438
01033201,01,03,32,01,14193,9418,9890,4775,5115,4303,100.0,66.35665468893116,69.6822377228211,33.643345311068835,36.03889241175227,30.31776227717889
01033202,01,03,32,02,10443,6224,7287,4219,3068,3156,100.0,59.599731877812886,69.77879919563344,40.400268122187114,29.37853107344633,30.22120080436656
01033203,01,03,32,03,14657,9466,8805,5191,3614,5852,100.0,64.5834754724705,60.07368492870301,35.41652452752951,24.6571604011735,39.92631507129699
01044101,01,04,41,01,20529,10333,14067,10196,3871,6462,100.0,50.333674314384524,68.52257781674705,49.66632568561547,18.85625213113157,31.477422183252955
01044102,01,04,41,02,16506,7160,12340,9346,2994,4166,100.0,43.378165515570096,74.76069308130377,56.6218344844299,18.138858596873863,25.23930691869623
01044103,01,04,41,03,8643,4643,5477,4000,1477,3166,100.0,53.71977322688881,63.36920050908249,46.28022677311119,17.088973735971305,36.630799490917504
01044201,01,04,42,01,23685,16244,13508,7441,6067,10177,100.0,68.58349166138906,57.031876715220605,31.41650833861094,25.61536837660967,42.968123284779395
01044202,01,04,42,02,16648,9796,9894,6852,3042,6754,100.0,58.841902931283045,59.43056222969726,41.15809706871696,18.272465160980296,40.56943777030274
01044203,01,04,42,03,15787,9459,9581,6328,3253,6206,100.0,59.91638690061443,60.689174637359855,40.083613099385566,20.605561537974282,39.310825362640145
02010101,02,01,01,01,6281,4366,3741,1915,1826,2540,100.0,69.51122432733641,59.56057952555326,30.488775672663586,29.071803852889666,40.43942047444675
02010102,02,01,01,02,14029,9558,9270,4471,4799,4759,100.0,68.13030151828356,66.07741107705468,31.869698481716448,34.20771259533823,33.92258892294533
02010103,02,01,01,03,15171,10702,9768,4469,5299,5403,100.0,70.54248236767518,64.3859996045086,29.45751763232483,34.928481972183775,35.614000395491395
02010104,02,01,01,04,5009,3273,3411,1736,1675,1598,100.0,65.34238370932322,68.09742463565583,34.65761629067678,33.43980834497904,31.902575364344184
02020201,02,02,02,01,2067,829,1587,1238,349,480,100.0,40.10643444605709,76.77793904208998,59.89356555394292,16.884373488147073,23.222060957910013
02020202,02,02,02,02,6008,2663,4317,3345,972,1691,100.0,44.32423435419441,71.85419440745673,55.6757656458056,16.17842876165113,28.145805592543276
02020203,02,02,02,03,10969,4456,8242,6513,1729,2727,100.0,40.62357553104203,75.13902817029812,59.37642446895798,15.762603701340142,24.860971829701885
02020204,02,02,02,04,12384,5420,8951,6964,1987,3433,100.0,43.76614987080104,72.27874677002583,56.23385012919897,16.044896640826874,27.721253229974156
02020205,02,02,02,05,14760,6176,11116,8584,2532,3644,100.0,41.84281842818428,75.31165311653116,58.15718157181572,17.154471544715445,24.688346883468835
02020206,02,02,02,06,18886,9019,13547,9867,3680,5339,100.0,47.754950757174626,71.73038229376257,52.24504924282537,19.4853330509372,28.269617706237426
02030301,02,03,03,01,8775,5537,5503,3238,2265,3272,100.0,63.099715099715105,62.712250712250714,36.9002849002849,25.811965811965816,37.287749287749286
02030302,02,03,03,02,12938,7120,8677,5818,2859,4261,100.0,55.03168959653733,67.0660071108363,44.96831040346267,22.09769670737363,32.933992889163704
02030401,02,03,04,01,14955,7436,10193,7519,2674,4762,100.0,49.722500835840854,68.15780675359412,50.277499164159146,17.88030758943497,31.842193246405888
02030402,02,03,04,02,10903,5590,7269,5313,1956,3634,100.0,51.27029258002385,66.66972392919381,48.72970741997615,17.940016509217646,33.3302760708062
02040501,02,04,05,01,5451,1726,4487,3725,762,964,100.0,31.663914878004036,82.31517152815996,68.33608512199596,13.979086406164006,17.68482847184003
02040502,02,04,05,02,7858,2670,6179,5188,991,1679,100.0,33.97811147874778,78.6332400101807,66.02188852125222,12.611351488928479,21.366759989819293
02040503,02,04,05,03,11262,3329,9130,7933,1197,2132,100.0,29.55958089149352,81.06908186822945,70.44041910850648,10.628662759722962,18.930918131770554
02040701,02,04,07,01,13307,6080,9371,7227,2144,3936,100.0,45.690238220485455,70.42158262568573,54.309761779514545,16.111820846171188,29.57841737431427
02040702,02,04,07,02,11314,3783,8607,7531,1076,2707,100.0,33.436450415414534,76.07389075481704,66.56354958458547,9.510341170231571,23.926109245182957
02040703,02,04,07,03,1136,782,445,354,91,691,100.0,68.83802816901408,39.17253521126761,31.161971830985912,8.01056338028169,60.8274647887324
02050601,02,05,06,01,9134,3266,6839,5868,971,2295,100.0,35.75651412305671,74.87409678125684,64.24348587694328,10.630610904313553,25.125903218743158
02050602,02,05,06,02,22173,7575,16914,14598,2316,5259,100.0,34.16317142470572,76.28196455148154,65.83682857529428,10.445135976187254,23.718035448518467
02050801,02,05,08,01,20872,8202,14992,12670,2322,5880,100.0,39.29666538903794,71.82828669988501,60.70333461096206,11.124952088922958,28.171713300114988
02050802,02,05,08,02,21568,7742,15942,13826,2116,5626,100.0,35.89577151335311,73.91505934718101,64.10422848664689,9.810830860534123,26.08494065281899
02050803,02,05,08,03,7868,3007,5719,4861,858,2149,100.0,38.218098627351296,72.68683274021353,61.781901372648704,10.90493136756482,27.313167259786475
02050804,02,05,08,04,4709,1078,4207,3631,576,502,100.0,22.892333828838392,89.33956253981738,77.10766617116161,12.231896368655766,10.660437460182628
03010101,03,01,01,01,4305,725,3835,3580,255,470,100.0,16.840882694541232,89.08246225319397,83.15911730545878,5.923344947735192,10.91753774680604
03010102,03,01,01,02,12165,2527,10323,9638,685,1842,100.0,20.77270859021784,84.85819975339088,79.22729140978217,5.630908343608714,15.141800246609124
03010104,03,01,01,04,222,55,189,167,22,33,100.0,24.774774774774773,85.13513513513513,75.22522522522522,9.90990990990991,14.864864864864865
03020203,03,02,02,03,2058,127,2011,1931,80,47,100.0,6.171039844509233,97.71622934888241,93.82896015549078,3.8872691933916426,2.28377065111759
03020209,03,02,02,09,15100,2635,13573,12465,1108,1527,100.0,17.450331125827816,89.88741721854304,82.54966887417218,7.33774834437086,10.112582781456954
03020210,03,02,02,10,11464,1922,10378,9542,836,1086,100.0,16.76552686671319,90.52686671318911,83.23447313328681,7.292393579902303,9.473133286810887
03020307,03,02,03,07,18419,2700,17195,15719,1476,1224,100.0,14.658776263640805,93.35468809381616,85.3412237363592,8.013464357456975,6.6453119061838315
03030405,03,03,04,05,11455,2264,10120,9191,929,1335,100.0,19.764295067656047,88.3457005674378,80.23570493234395,8.109995635093846,11.6542994325622
03030406,03,03,04,06,8239,773,7907,7466,441,332,100.0,9.38220657846826,95.97038475543148,90.61779342153173,5.352591333899745,4.029615244568515
03030711,03,03,07,11,6913,603,6655,6310,345,258,100.0,8.722696369159555,96.26790105598148,91.27730363084045,4.990597425141038,3.732098944018516
03030715,03,03,07,15,7779,1591,6694,6188,506,1085,100.0,20.45250032137807,86.05219179843168,79.54749967862193,6.504692119809745,13.947808201568327
03030716,03,03,07,16,1120,48,1103,1072,31,17,100.0,4.285714285714286,98.48214285714286,95.71428571428572,2.767857142857143,1.5178571428571428
03040508,03,04,05,08,4742,999,4404,3743,661,338,100.0,21.067060312104598,92.87220582032899,78.9329396878954,13.939266132433573,7.127794179671025
03040512,03,04,05,12,10438,1998,9449,8440,1009,989,100.0,19.14159800728109,90.52500479018968,80.85840199271891,9.66660279747078,9.474995209810308
03040513,03,04,05,13,3509,652,3189,2857,332,320,100.0,18.580792248503847,90.8805927614705,81.41920775149615,9.461385009974352,9.119407238529496
03040614,03,04,06,14,37240,6568,33611,30672,2939,3629,100.0,17.636949516648766,90.25510204081633,82.36305048335123,7.8920515574650905,9.744897959183675
03040818,03,04,08,18,35738,7037,31213,28701,2512,4525,100.0,19.690525491073927,87.33840729755443,80.30947450892607,7.02893278862835,12.661592702445576
03050919,03,05,09,19,5096,710,4612,4386,226,484,100.0,13.932496075353217,90.50235478806907,86.06750392464679,4.434850863422292,9.497645211930926
03050920,03,05,09,20,7551,1302,6776,6249,527,775,100.0,17.24274930472785,89.7364587471858,82.75725069527215,6.979208051913653,10.263541252814196
03050923,03,05,09,23,10049,2608,8325,7441,884,1724,100.0,25.952831127475374,82.84406408597872,74.04716887252462,8.796895213454075,17.155935914021295
03050924,03,05,09,24,6407,1628,5306,4779,527,1101,100.0,25.40970813173092,82.81567036054315,74.59029186826908,8.225378492274075,17.184329639456845
03050925,03,05,09,25,9819,2052,8506,7767,739,1313,100.0,20.89825847846013,86.62796618800284,79.10174152153986,7.52622466646298,13.372033811997147
03051017,03,05,10,17,4212,981,3527,3231,296,685,100.0,23.29059829059829,83.7369420702754,76.70940170940172,7.027540360873694,16.263057929724596
03051021,03,05,10,21,6981,1119,6231,5862,369,750,100.0,16.02922217447357,89.25655350236356,83.97077782552643,5.28577567683713,10.743446497636441
03051022,03,05,10,22,4640,548,4318,4092,226,322,100.0,11.810344827586206,93.0603448275862,88.1896551724138,4.870689655172414,6.939655172413793
03061126,03,06,11,26,16255,5324,12657,10931,1726,3598,100.0,32.752999077207015,77.8652722239311,67.24700092279299,10.618271301138112,22.134727776068903
03061131,03,06,11,31,10744,3798,8137,6946,1191,2607,100.0,35.34996276991809,75.73529411764706,64.6500372300819,11.085256887565151,24.264705882352942
03061227,03,06,12,27,14632,4101,11956,10531,1425,2676,100.0,28.02761071623838,81.71131765992345,71.97238928376161,9.738928376161837,18.288682340076544
03061228,03,06,12,28,12813,3459,10508,9354,1154,2305,100.0,26.996019667525168,82.01045812846328,73.00398033247482,9.006477795988449,17.989541871536723
03061332,03,06,13,32,22534,7454,17594,15080,2514,4940,100.0,33.07890299103577,78.07757166947724,66.92109700896424,11.156474660513002,21.922428330522767
03061429,03,06,14,29,9970,1931,8805,8039,766,1165,100.0,19.368104312938815,88.3149448345035,80.63189568706119,7.683049147442326,11.68505516549649
03061430,03,06,14,30,3965,1673,2606,2292,314,1359,100.0,42.19419924337957,65.72509457755359,57.80580075662043,7.919293820933166,34.27490542244641
03061434,03,06,14,34,6373,1927,5018,4446,572,1355,100.0,30.236937078299075,78.73842774203672,69.76306292170092,8.975364820335791,21.261572257963284
03061435,03,06,14,35,4063,1307,3175,2756,419,888,100.0,32.1683485109525,78.14422840265813,67.8316514890475,10.312576913610632,21.855771597341867
03061441,03,06,14,41,2825,817,2387,2008,379,438,100.0,28.920353982300885,84.49557522123894,71.07964601769912,13.415929203539822,15.504424778761061
03071536,03,07,15,36,11328,4314,8451,7014,1437,2877,100.0,38.08262711864407,74.60275423728814,61.91737288135594,12.685381355932204,25.39724576271186
03071537,03,07,15,37,15930,5747,12021,10183,1838,3909,100.0,36.07658505963591,75.46139359698681,63.9234149403641,11.537978656622725,24.538606403013183
03071633,03,07,16,33,3188,1040,2488,2148,340,700,100.0,32.622333751568384,78.04265997490589,67.37766624843162,10.664993726474279,21.9573400250941
03071638,03,07,16,38,17612,5918,13742,11694,2048,3870,100.0,33.60208948444242,78.02634567340449,66.39791051555758,11.628435157846923,21.973654326595504
03071639,03,07,16,39,12823,3635,10570,9188,1382,2253,100.0,28.347500584886532,82.4300085783358,71.65249941511347,10.777509163222335,17.569991421664195
04010101,04,01,01,01,10765,5402,7619,5363,2256,3146,100.0,50.18114259173247,70.7756618671621,49.81885740826753,20.956804458894567,29.2243381328379
04010102,04,01,01,02,783,323,513,460,53,270,100.0,41.251596424010216,65.51724137931035,58.748403575989784,6.7688378033205625,34.48275862068966
04010103,04,01,01,03,7855,4401,5649,3454,2195,2206,100.0,56.02800763844685,71.91597708465946,43.971992361553156,27.9439847231063,28.084022915340544
04020204,04,02,02,04,178,66,137,112,25,41,100.0,37.07865168539326,76.96629213483146,62.92134831460674,14.04494382022472,23.03370786516854
04020205,04,02,02,05,1304,337,1116,967,149,188,100.0,25.84355828220859,85.58282208588957,74.15644171779141,11.42638036809816,14.417177914110429
04020206,04,02,02,06,2832,900,2249,1932,317,583,100.0,31.779661016949152,79.4138418079096,68.22033898305084,11.193502824858758,20.586158192090394
04020207,04,02,02,07,2569,829,2089,1740,349,480,100.0,32.26936551187232,81.31568703775788,67.73063448812768,13.585052549630205,18.684312962242117
04020208,04,02,02,08,2963,840,2537,2123,414,426,100.0,28.34964562942963,85.62267971650354,71.65035437057037,13.972325345933175,14.377320283496456
04020209,04,02,02,09,3140,1217,2206,1923,283,934,100.0,38.75796178343949,70.2547770700637,61.242038216560516,9.012738853503183,29.745222929936304
04020310,04,02,03,10,806,531,345,275,70,461,100.0,65.88089330024815,42.80397022332506,34.11910669975186,8.6848635235732,57.19602977667494
04020311,04,02,03,11,14745,4924,11936,9821,2115,2809,100.0,33.39437097321126,80.94947439810105,66.60562902678873,14.343845371312309,19.050525601898947
04020312,04,02,03,12,5573,1885,4424,3688,736,1149,100.0,33.82379328907231,79.38273820204557,66.17620671092769,13.20653149111789,20.617261797954423
04020313,04,02,03,13,7212,2803,5533,4409,1124,1679,100.0,38.865779256794234,76.71935662784249,61.134220743205766,15.585135884636717,23.280643372157513
04020314,04,02,03,14,6,6,0,0,0,6,100.0,100.0,0.0,0.0,0.0,100.0
04030415,04,03,04,15,3329,1858,1957,1471,486,1372,100.0,55.812556323220186,58.786422349053765,44.187443676779814,14.598978672273958,41.213577650946235
04030416,04,03,04,16,10334,4992,7613,5342,2271,2721,100.0,48.30656086704084,73.66944068124637,51.69343913295916,21.976001548287208,26.330559318753625
04030417,04,03,04,17,10786,4203,8326,6583,1743,2460,100.0,38.96717967735954,77.19265714815502,61.03282032264046,16.159836825514557,22.807342851844982
04030518,04,03,05,18,9637,4538,6924,5099,1825,2713,100.0,47.089343156584,71.84808550378749,52.91065684341601,18.937428660371484,28.151914496212516
04030519,04,03,05,19,5930,2784,4264,3146,1118,1666,100.0,46.94772344013491,71.90556492411467,53.0522765598651,18.85328836424958,28.094435075885325
04030620,04,03,06,20,8859,4032,6474,4827,1647,2385,100.0,45.51303758889265,73.0782255333559,54.486962411107356,18.59126312224856,26.921774466644088
04030621,04,03,06,21,3429,2044,2151,1385,766,1278,100.0,59.60921551472732,62.72965879265092,40.390784485272675,22.338874307378244,37.270341207349084
04030622,04,03,06,22,10811,5276,7734,5535,2199,3077,100.0,48.80214596244566,71.53824808065859,51.19785403755435,20.340394043104247,28.46175191934141
04030623,04,03,06,23,5157,2984,3444,2173,1271,1713,100.0,57.863098700795035,66.78301337987202,42.136901299204965,24.646112080667056,33.21698662012798
04030724,04,03,07,24,6488,2527,4978,3961,1017,1510,100.0,38.948828606658445,76.72626387176325,61.051171393341555,15.675092478421702,23.273736128236745
04030725,04,03,07,25,12142,5053,8989,7089,1900,3153,100.0,41.61587876791303,74.03228463185637,58.38412123208697,15.648163399769397,25.967715368143633
04030726,04,03,07,26,5641,2575,4106,3066,1040,1535,100.0,45.64793476333983,72.78851267505762,54.35206523666017,18.436447438397447,27.211487324942386
04030827,04,03,08,27,12155,6690,7828,5465,2363,4327,100.0,55.03907856849033,64.4014808720691,44.96092143150967,19.44055944055944,35.59851912793089
04030828,04,03,08,28,9538,4414,6689,5124,1565,2849,100.0,46.278045711889284,70.13000629062697,53.721954288110716,16.408052002516254,29.869993709373034
04030929,04,03,09,29,5964,2630,4397,3334,1063,1567,100.0,44.097920858484244,73.72568745808182,55.902079141515756,17.823608316566066,26.274312541918178
04030930,04,03,09,30,5597,2611,3996,2986,1010,1601,100.0,46.64999106664284,71.3953903877077,53.35000893335715,18.045381454350544,28.604609612292297
04030931,04,03,09,31,3581,2053,2222,1528,694,1359,100.0,57.33035464953924,62.04970678581402,42.66964535046077,19.380061435353255,37.95029321418598
04031032,04,03,10,32,15602,6890,11540,8712,2828,4062,100.0,44.16100499935906,73.96487629791052,55.83899500064094,18.12588129726958,26.035123702089475
04041133,04,04,11,33,110,73,49,37,12,61,100.0,66.36363636363637,44.54545454545455,33.63636363636363,10.909090909090908,55.45454545454545
04041134,04,04,11,34,5470,2329,4185,3141,1044,1285,100.0,42.57769652650823,76.50822669104204,57.42230347349177,19.085923217550274,23.491773308957953
04041135,04,04,11,35,2786,1051,2231,1735,496,555,100.0,37.724335965542,80.07896625987078,62.275664034458,17.80330222541278,19.921033740129218
04041136,04,04,11,36,3173,1169,2556,2004,552,617,100.0,36.84210526315789,80.5546801134573,63.1578947368421,17.39678537661519,19.445319886542702
04041137,04,04,11,37,8264,3289,6455,4975,1480,1809,100.0,39.79912875121007,78.10987415295256,60.20087124878993,17.909002904162634,21.890125847047432
04041238,04,04,12,38,6081,2205,5032,3876,1156,1049,100.0,36.26048347311298,82.74954777174807,63.73951652688703,19.010031244861043,17.250452228251934
04041239,04,04,12,39,1038,642,576,396,180,462,100.0,61.849710982658955,55.49132947976878,38.15028901734104,17.341040462427745,44.50867052023121
04041240,04,04,12,40,1513,425,1292,1088,204,221,100.0,28.08988764044944,85.39325842696628,71.91011235955057,13.48314606741573,14.606741573033707
04041241,04,04,12,41,7023,1878,5983,5145,838,1040,100.0,26.74070909867578,85.19151359817741,73.25929090132422,11.932222696853197,14.808486401822583
04041342,04,04,13,42,4178,1533,3328,2645,683,850,100.0,36.692197223551936,79.65533748204882,63.307802776448064,16.347534705600765,20.34466251795117
04041343,04,04,13,43,3574,1170,2984,2404,580,590,100.0,32.736429770565195,83.49188584219362,67.2635702294348,16.228315612758813,16.508114157806382
04041344,04,04,13,44,10593,3006,8874,7587,1287,1719,100.0,28.377230246389125,83.77230246389125,71.62276975361087,12.149532710280374,16.22769753610875
04051445,04,05,14,45,6496,2991,4894,3505,1389,1602,100.0,46.04371921182266,75.33866995073892,53.95628078817734,21.382389162561577,24.661330049261085
04051446,04,05,14,46,11048,5040,8135,6008,2127,2913,100.0,45.61911658218682,73.63323678493845,54.38088341781317,19.25235336712527,26.36676321506155
04051447,04,05,14,47,5283,2258,3971,3025,946,1312,100.0,42.74086693166762,75.16562559151997,57.25913306833239,17.906492523187584,24.83437440848003
04051448,04,05,14,48,9334,4507,6516,4827,1689,2818,100.0,48.285836725948144,69.80929933576174,51.71416327405185,18.095136061709876,30.190700664238268
04051549,04,05,15,49,4715,2158,3361,2557,804,1354,100.0,45.76882290562036,71.2831389183457,54.23117709437963,17.051961823966067,28.716861081654294
04051550,04,05,15,50,5625,2439,4178,3186,992,1447,100.0,43.36,74.27555555555556,56.64,17.635555555555555,25.724444444444444
04051551,04,05,15,51,4436,1992,3314,2444,870,1122,100.0,44.90532010820559,74.70694319206493,55.09467989179441,19.612263300270513,25.293056807935077
04051652,04,05,16,52,9834,3989,7416,5845,1571,2418,100.0,40.56335163717714,75.411836485662,59.436648362822865,15.975188122839128,24.58816351433801
04051653,04,05,16,53,6913,3015,5108,3898,1210,1805,100.0,43.61348184579777,73.88977289165341,56.38651815420223,17.50325473745118,26.110227108346596
04051654,04,05,16,54,3071,1177,2376,1894,482,695,100.0,38.32627808531423,77.36893520026051,61.67372191468578,15.69521328557473,22.631064799739498
04051655,04,05,16,55,7489,3395,5542,4094,1448,1947,100.0,45.33315529443183,74.00186940846575,54.66684470556816,19.33502470289758,25.998130591534252
04051656,04,05,16,56,7572,2528,6123,5044,1079,1449,100.0,33.38615953512942,80.86370839936609,66.61384046487058,14.24986793449551,19.136291600633914
04061757,04,06,17,57,62,18,47,44,3,15,100.0,29.03225806451613,75.80645161290323,70.96774193548387,4.838709677419355,24.193548387096776
05010101,05,01,01,01,10672,3263,9090,7409,1681,1582,100.0,30.575337331334335,85.17616191904048,69.42466266866568,15.751499250374811,14.82383808095952
05010102,05,01,01,02,8500,3162,6551,5338,1213,1949,100.0,37.2,77.07058823529411,62.8,14.270588235294118,22.929411764705883
05010103,05,01,01,03,7608,1512,6901,6096,805,707,100.0,19.873817034700316,90.70715036803365,80.12618296529969,10.580967402733963,9.292849631966352
05010204,05,01,02,04,3619,1597,2718,2022,696,901,100.0,44.1282122133186,75.10361978447084,55.8717877866814,19.231831997789445,24.896380215529152
05010205,05,01,02,05,2314,631,2069,1683,386,245,100.0,27.26879861711322,89.41227312013828,72.73120138288678,16.681071737251514,10.58772687986171
05010206,05,01,02,06,10703,4746,8095,5957,2138,2608,100.0,44.34270765206017,75.63300009343175,55.65729234793984,19.97570774549192,24.36699990656825
05010207,05,01,02,07,11547,6039,8776,5508,3268,2771,100.0,52.29929851909587,76.0024248722612,47.70070148090413,28.301723391357065,23.997575127738806
05010208,05,01,02,08,7709,2893,5926,4816,1110,1783,100.0,37.527565183551694,76.87118951874432,62.472434816448306,14.398754702296019,23.128810481255673
05010209,05,01,02,09,6068,2033,5074,4035,1039,994,100.0,33.50362557679631,83.61898483849703,66.49637442320369,17.122610415293344,16.381015161502965
05010310,05,01,03,10,4025,1651,2979,2374,605,1046,100.0,41.018633540372676,74.01242236024844,58.981366459627324,15.031055900621118,25.987577639751553
05010311,05,01,03,11,5756,2999,4231,2757,1474,1525,100.0,52.10215427380125,73.50590687977763,47.89784572619875,25.608061153578877,26.494093120222377
05010312,05,01,03,12,7335,4313,4199,3022,1177,3136,100.0,58.800272665303346,57.24608043626449,41.19972733469666,16.046353101567824,42.753919563735515
05010313,05,01,03,13,6753,3041,4801,3712,1089,1952,100.0,45.03183770176218,71.09432844661632,54.96816229823782,16.1261661483785,28.905671553383684
05010314,05,01,03,14,12340,4993,9513,7347,2166,2827,100.0,40.46191247974068,77.09076175040519,59.53808752025932,17.55267423014587,22.909238249594814
05010339,05,01,03,39,957,660,361,297,64,596,100.0,68.96551724137932,37.72204806687565,31.03448275862069,6.687565308254964,62.27795193312434
05020415,05,02,04,15,3839,849,3584,2990,594,255,100.0,22.115134149518102,93.3576452201094,77.8848658504819,15.472779369627506,6.642354779890597
05020416,05,02,04,16,1694,106,1665,1588,77,29,100.0,6.257378984651712,98.28807556080284,93.74262101534829,4.545454545454546,1.7119244391971666
05020417,05,02,04,17,5780,1801,4951,3979,972,829,100.0,31.15916955017301,85.65743944636678,68.84083044982698,16.81660899653979,14.342560553633218
05020418,05,02,04,18,4386,1251,3627,3135,492,759,100.0,28.522571819425448,82.69493844049248,71.47742818057455,11.21751025991792,17.30506155950752
05020419,05,02,04,19,7200,2332,5929,4868,1061,1271,100.0,32.388888888888886,82.34722222222223,67.61111111111111,14.73611111111111,17.65277777777778
05020420,05,02,04,20,1170,235,1059,935,124,111,100.0,20.085470085470085,90.51282051282051,79.91452991452992,10.598290598290598,9.487179487179487
05020521,05,02,05,21,3254,942,2889,2312,577,365,100.0,28.94898586355255,88.78303626306085,71.05101413644745,17.732022126613398,11.216963736939151
05020522,05,02,05,22,7571,3741,5170,3830,1340,2401,100.0,49.41223088099326,68.28688416325453,50.58776911900673,17.699115044247787,31.713115836745477
05020523,05,02,05,23,12398,7534,8305,4864,3441,4093,100.0,60.767865784804,66.98661074366832,39.232134215196,27.75447652847233,33.01338925633166
05020524,05,02,05,24,6241,1519,5497,4722,775,744,100.0,24.33904822945041,88.07883352026919,75.66095177054959,12.417881749719596,11.921166479730811
05020625,05,02,06,25,7858,3135,5948,4723,1225,1910,100.0,39.89564774751845,75.69356070246882,60.104352252481554,15.589208449987273,24.306439297531178
05020626,05,02,06,26,18268,6837,13985,11431,2554,4283,100.0,37.42610028465075,76.55463104882855,62.57389971534925,13.980731333479307,23.445368951171446
05020627,05,02,06,27,4453,2092,3109,2361,748,1344,100.0,46.9795643386481,69.81810015719739,53.0204356613519,16.797664495845495,30.181899842802608
05020628,05,02,06,28,2003,550,1752,1453,299,251,100.0,27.45881178232651,87.46879680479282,72.5411882176735,14.92760858711932,12.531203195207189
05020629,05,02,06,29,4436,721,4097,3715,382,339,100.0,16.25338142470694,92.35798016230838,83.74661857529306,8.61136158701533,7.642019837691614
05030730,05,03,07,30,4608,2551,3700,2057,1643,908,100.0,55.36024305555556,80.29513888888889,44.63975694444444,35.65538194444444,19.70486111111111
05030731,05,03,07,31,11885,5366,9232,6519,2713,2653,100.0,45.14934791754312,77.67774505679428,54.850652082456875,22.8270929743374,22.32225494320572
05030832,05,03,08,32,12254,5881,8859,6373,2486,3395,100.0,47.99249224742941,72.29476089440183,52.00750775257059,20.287253141831236,27.705239105598174
05030833,05,03,08,33,486,240,355,246,109,131,100.0,49.382716049382715,73.04526748971193,50.617283950617285,22.42798353909465,26.954732510288064
05040934,05,04,09,34,3198,637,2949,2561,388,249,100.0,19.91869918699187,92.21388367729831,80.08130081300813,12.132582864290182,7.786116322701689
05040935,05,04,09,35,444,107,374,337,37,70,100.0,24.0990990990991,84.23423423423422,75.90090090090091,8.333333333333332,15.765765765765765
05040936,05,04,09,36,10315,1912,9696,8403,1293,619,100.0,18.53611245758604,93.99903053805139,81.46388754241396,12.535142995637422,6.0009694619486185
05040937,05,04,09,37,2198,375,2056,1823,233,142,100.0,17.060964513193813,93.5395814376706,82.93903548680619,10.600545950864422,6.46041856232939
05040938,05,04,09,38,3682,587,3460,3095,365,222,100.0,15.942422596414993,93.97066811515481,84.057577403585,9.913090711569799,6.029331884845193
06010101,06,01,01,01,6988,1879,6029,5109,920,959,100.0,26.888952489982827,86.27647395535203,73.11104751001717,13.16542644533486,13.723526044647969
06010102,06,01,01,02,8808,3211,7087,5597,1490,1721,100.0,36.455495004541326,80.46094459582199,63.544504995458674,16.916439600363304,19.539055404178022
06010103,06,01,01,03,6281,2055,5228,4226,1002,1053,100.0,32.717720108263016,83.23515363795573,67.28227989173699,15.952873746218755,16.76484636204426
06010204,06,01,02,04,6887,2471,5613,4416,1197,1274,100.0,35.87919268186438,81.50137941048352,64.12080731813562,17.3805720923479,18.498620589516477
06010205,06,01,02,05,9881,3328,8163,6553,1610,1718,100.0,33.680801538305836,82.61309584050197,66.31919846169416,16.293897378807813,17.386904159498027
06010206,06,01,02,06,7694,2340,6467,5354,1113,1227,100.0,30.413309072004157,84.05250844814141,69.58669092799585,14.465817520145569,15.947491551858592
06010207,06,01,02,07,8008,2762,6530,5246,1284,1478,100.0,34.49050949050949,81.54345654345654,65.5094905094905,16.033966033966035,18.456543456543457
06010208,06,01,02,08,6824,2147,5704,4677,1027,1120,100.0,31.46248534583822,83.5873388042204,68.53751465416178,15.049824150058615,16.412661195779602
06010209,06,01,02,09,9339,3337,7542,6002,1540,1797,100.0,35.73187707463325,80.75811114680373,64.26812292536674,16.489988221436985,19.241888853196272
06010210,06,01,02,10,4868,1422,4109,3446,663,759,100.0,29.211175020542317,84.40838126540675,70.78882497945769,13.619556285949056,15.591618734593263
06020301,06,02,03,01,4937,1198,4371,3739,632,566,100.0,24.265748430220782,88.53554790358518,75.73425156977922,12.801296333805956,11.464452096414828
06020302,06,02,03,02,6097,1944,4959,4153,806,1138,100.0,31.88453337707069,81.33508282762014,68.1154666229293,13.219616204690832,18.66491717237986
06020303,06,02,03,03,7410,2395,6153,5015,1138,1257,100.0,32.32118758434548,83.03643724696357,67.67881241565452,15.35762483130904,16.963562753036438
06020304,06,02,03,04,7313,2224,6197,5089,1108,1116,100.0,30.411595788322167,84.73950499111172,69.58840421167784,15.151100779433884,15.260495008888281
06020305,06,02,03,05,11399,4072,9221,7327,1894,2178,100.0,35.722431792262476,80.89306079480656,64.27756820773752,16.615492587069042,19.106939205193438
06020306,06,02,03,06,6402,1313,5825,5089,736,577,100.0,20.509215870040613,90.98719150265542,79.4907841299594,11.496407372696032,9.01280849734458
06020407,06,02,04,07,4636,2337,3413,2299,1114,1223,100.0,50.409836065573764,73.61949956859361,49.59016393442623,24.02933563416739,26.380500431406382
06020408,06,02,04,08,7055,2047,5946,5008,938,1109,100.0,29.0148830616584,84.28065201984408,70.98511693834159,13.29553508150248,15.719347980155918
06020409,06,02,04,09,8349,2221,7123,6128,995,1226,100.0,26.601988262067312,85.31560665948018,73.39801173793269,11.91759492154749,14.684393340519822
06020410,06,02,04,10,7062,1541,6163,5521,642,899,100.0,21.821013877088642,87.26989521382045,78.17898612291135,9.090909090909092,12.730104786179552
06020411,06,02,04,11,8627,2346,7501,6281,1220,1126,100.0,27.193694215834007,86.94795409760056,72.80630578416599,14.141648313434565,13.052045902399442
06030501,06,03,05,01,5670,1365,4850,4305,545,820,100.0,24.074074074074073,85.5379188712522,75.92592592592592,9.611992945326278,14.462081128747794
06030502,06,03,05,02,5616,1397,4864,4219,645,752,100.0,24.875356125356127,86.6096866096866,75.12464387464387,11.485042735042734,13.390313390313391
06030503,06,03,05,03,11696,3484,9905,8212,1693,1791,100.0,29.787961696306432,84.68707250341997,70.21203830369357,14.475034199726403,15.312927496580029
06030504,06,03,05,04,11050,2584,9832,8466,1366,1218,100.0,23.384615384615383,88.97737556561086,76.61538461538461,12.361990950226245,11.02262443438914
06030605,06,03,06,05,7088,2003,6009,5085,924,1079,100.0,28.25902934537246,84.77708803611738,71.74097065462755,13.036117381489841,15.222911963882618
06030606,06,03,06,06,5612,2203,4214,3409,805,1398,100.0,39.2551674982181,75.08909479686386,60.7448325017819,14.344262295081966,24.910905203136135
06030607,06,03,06,07,3152,1209,2278,1943,335,874,100.0,38.35659898477157,72.27157360406092,61.64340101522843,10.628172588832488,27.72842639593909
06030608,06,03,06,08,13747,3997,11903,9750,2153,1844,100.0,29.075434640285152,86.58616425401905,70.92456535971485,15.661598894304213,13.413835745980943
06030609,06,03,06,09,12046,3075,10389,8971,1418,1657,100.0,25.52714594056118,86.2443964801594,74.47285405943882,11.771542420720571,13.755603519840612
06030610,06,03,06,10,8511,2064,7417,6447,970,1094,100.0,24.25096933380331,87.14604629303254,75.74903066619669,11.39701562683586,12.853953706967452
06040701,06,04,07,01,10126,2294,8888,7832,1056,1238,100.0,22.654552636776614,87.77404700770293,77.34544736322339,10.428599644479558,12.225952992297056
06040702,06,04,07,02,5234,1103,4783,4131,652,451,100.0,21.07374856706152,91.38326327856325,78.92625143293847,12.457011845624761,8.61673672143676
06040703,06,04,07,03,11498,3622,8947,7876,1071,2551,100.0,31.50113063141416,77.81353278831101,68.49886936858584,9.31466341972517,22.18646721168899
06040804,06,04,08,04,7511,1415,6833,6096,737,678,100.0,18.83903608041539,90.97323924910133,81.1609639195846,9.812275329516709,9.026760750898683
06040805,06,04,08,05,5278,1230,4683,4048,635,595,100.0,23.30428192497158,88.72679045092838,76.69571807502842,12.031072375899962,11.273209549071618
06040806,06,04,08,06,7266,1225,6667,6041,626,599,100.0,16.859344894026975,91.75612441508395,83.14065510597302,8.615469309110928,8.243875584916047
06040807,06,04,08,07,5958,1496,5220,4462,758,738,100.0,25.10909701242027,87.61329305135952,74.89090298757972,12.722390063779793,12.386706948640484
06040808,06,04,08,08,4810,1808,4113,3002,1111,697,100.0,37.58835758835759,85.50935550935552,62.41164241164241,23.0977130977131,14.490644490644492
06040809,06,04,08,09,4902,1501,4006,3401,605,896,100.0,30.620155038759687,81.72174622603019,69.37984496124031,12.34190126478988,18.27825377396981
06040810,06,04,08,10,7204,2346,5954,4858,1096,1250,100.0,32.565241532481956,82.64852859522487,67.43475846751804,15.21377012770683,17.351471404775126
07010101,07,01,01,01,9808,4807,7011,5001,2010,2797,100.0,49.0110114192496,71.48246329526917,50.9889885807504,20.49347471451876,28.517536704730833
07010102,07,01,01,02,16387,9340,10667,7047,3620,5720,100.0,56.99639958503692,65.09428205284676,43.00360041496308,22.090681637883687,34.90571794715323
07010103,07,01,01,03,10468,4194,7989,6274,1715,2479,100.0,40.064959877722586,76.31830340084066,59.935040122277414,16.38326327856324,23.681696599159345
07010104,07,01,01,04,13480,7600,9059,5880,3179,4421,100.0,56.37982195845698,67.2032640949555,43.62017804154303,23.583086053412465,32.796735905044514
07020201,07,02,02,01,10578,3839,8492,6739,1753,2086,100.0,36.292304783512954,80.2798260540745,63.707695216487046,16.572130837587444,19.720173945925506
07020202,07,02,02,02,10501,4793,7630,5708,1922,2871,100.0,45.64327206932673,72.65974669079135,54.356727930673266,18.303018760118086,27.340253309208645
07020203,07,02,02,03,17811,7934,13250,9877,3373,4561,100.0,44.54550558643535,74.39222952108247,55.454494413564646,18.937735107517824,25.607770478917523
07020204,07,02,02,04,12716,4916,9844,7800,2044,2872,100.0,38.659955960994026,77.4142812205096,61.34004403900598,16.074237181503616,22.585718779490406
07030301,07,03,03,01,24466,7015,20660,17451,3209,3806,100.0,28.67244339082809,84.44371781247445,71.32755660917192,13.116161203302543,15.556282187525547
07030302,07,03,03,02,9371,3043,7783,6328,1455,1588,100.0,32.47252160921993,83.0541030839825,67.52747839078008,15.526624693202434,16.9458969160175
07030303,07,03,03,03,12302,5489,9473,6813,2660,2829,100.0,44.618761177044384,77.0037392293936,55.381238822955616,21.62250040643798,22.996260770606405
07040401,07,04,04,01,17502,6768,14273,10734,3539,3229,100.0,38.66986630099417,81.5506799222946,61.33013369900583,20.220546223288768,18.449320077705405
07040402,07,04,04,02,2255,497,2034,1758,276,221,100.0,22.03991130820399,90.19955654101996,77.960088691796,12.239467849223946,9.800443458980045
07040403,07,04,04,03,24582,9718,19207,14864,4343,5375,100.0,39.53299161988447,78.13440728988691,60.46700838011553,17.66739890977138,21.86559271011309
07040404,07,04,04,04,5114,1433,4429,3681,748,685,100.0,28.021118498240128,86.60539694955025,71.97888150175987,14.626515447790378,13.394603050449746
07040405,07,04,04,05,11104,5116,8177,5988,2189,2927,100.0,46.07348703170029,73.64012968299711,53.92651296829971,19.71361671469741,26.35987031700288
07040406,07,04,04,06,3980,2275,2547,1705,842,1433,100.0,57.1608040201005,63.994974874371856,42.8391959798995,21.155778894472363,36.005025125628144
07050501,07,05,05,01,17028,7178,13300,9850,3450,3728,100.0,42.15409913084331,78.10664787408973,57.84590086915669,20.26074700493305,21.893352125910265
07050502,07,05,05,02,8141,3266,6242,4875,1367,1899,100.0,40.11792163124923,76.67362731851124,59.88207836875077,16.79154894976047,23.32637268148876
07050503,07,05,05,03,9101,3086,7635,6015,1620,1466,100.0,33.90836171849247,83.89188001318536,66.09163828150753,17.800241731677836,16.108119986814636
07050504,07,05,05,04,5653,1940,4767,3713,1054,886,100.0,34.31806120643906,84.32690606757474,65.68193879356095,18.644967274013798,15.67309393242526
07050505,07,05,05,05,10584,3192,9106,7392,1714,1478,100.0,30.158730158730158,86.0355253212396,69.84126984126983,16.194255479969765,13.964474678760395
07050506,07,05,05,06,2233,535,2013,1698,315,220,100.0,23.958799820868787,90.14778325123153,76.04120017913122,14.106583072100312,9.852216748768473
07060601,07,06,06,01,10193,4368,7763,5825,1938,2430,100.0,42.852938290984014,76.16010987932896,57.147061709015986,19.01304817031296,23.839890120671047
07060602,07,06,06,02,4740,1227,4202,3513,689,538,100.0,25.886075949367086,88.64978902953587,74.1139240506329,14.535864978902953,11.350210970464135
07060603,07,06,06,03,2869,1147,2358,1722,636,511,100.0,39.97908678982224,82.18891599860578,60.02091321017776,22.168002788428023,17.811084001394214
07060604,07,06,06,04,14462,5765,12109,8697,3412,2353,100.0,39.86308947586779,83.72977458166228,60.136910524132205,23.59286405753008,16.270225418337713
07070701,07,07,07,01,10498,2428,9398,8070,1328,1100,100.0,23.128214898075825,89.52181367879597,76.87178510192417,12.650028576871787,10.478186321204038
07070702,07,07,07,02,10895,2521,9899,8374,1525,996,100.0,23.139054612207435,90.85819183111519,76.86094538779257,13.997246443322625,9.14180816888481
07070703,07,07,07,03,8485,2598,7241,5887,1354,1244,100.0,30.618738951090158,85.3388332351208,69.38126104890983,15.95757218621096,14.6611667648792
07070704,07,07,07,04,8431,3393,6492,5038,1454,1939,100.0,40.244336377653894,77.00154192859684,59.7556636223461,17.24587830625074,22.998458071403157
07070705,07,07,07,05,6978,1401,6366,5577,789,612,100.0,20.07738607050731,91.22957867583835,79.9226139294927,11.306964746345658,8.770421324161651
07070706,07,07,07,06,3859,854,3361,3005,356,498,100.0,22.130085514381964,87.09510235812387,77.86991448561803,9.22518787250583,12.904897641876135
07070707,07,07,07,07,2964,561,2686,2403,283,278,100.0,18.927125506072876,90.62078272604587,81.07287449392713,9.547908232118758,9.379217273954115
08010115,08,01,01,15,1010,477,690,533,157,320,100.0,47.227722772277225,68.31683168316832,52.772277227722775,15.544554455445544,31.683168316831683
08010116,08,01,01,16,3542,2069,2156,1473,683,1386,100.0,58.413325804630155,60.86956521739131,41.58667419536985,19.282891022021456,39.130434782608695
08010117,08,01,01,17,15688,8110,10294,7578,2716,5394,100.0,51.69556348801632,65.61703212646609,48.30443651198368,17.312595614482408,34.38296787353391
08010118,08,01,01,18,12240,7493,7690,4747,2943,4550,100.0,61.21732026143791,62.826797385620914,38.782679738562095,24.044117647058822,37.173202614379086
08010211,08,01,02,11,9668,5673,5964,3995,1969,3704,100.0,58.67811336367398,61.68804302854779,41.32188663632602,20.36615639222176,38.31195697145222
08010212,08,01,02,12,7451,5015,4903,2436,2467,2548,100.0,67.30640182525835,65.80324788618978,32.693598174741645,33.10964971144813,34.19675211381023
08010213,08,01,02,13,12288,6818,7960,5470,2490,4328,100.0,55.485026041666664,64.77864583333334,44.51497395833333,20.263671875,35.22135416666667
08010214,08,01,02,14,8524,5092,5063,3432,1631,3461,100.0,59.73721257625528,59.3969967151572,40.262787423744726,19.134209291412482,40.6030032848428
08010301,08,01,03,01,27007,13507,18390,13500,4890,8617,100.0,50.01295960306587,68.0934572518236,49.98704039693413,18.106416854889474,31.9065427481764
08010302,08,01,03,02,3868,1470,3010,2398,612,858,100.0,38.004136504653566,77.81799379524303,61.995863495346434,15.822130299896585,22.18200620475698
08010303,08,01,03,03,8264,5054,4916,3210,1706,3348,100.0,61.156824782187805,59.48693126815101,38.843175217812195,20.64375605033882,40.51306873184898
08010404,08,01,04,04,23011,12312,15075,10699,4376,7936,100.0,53.50484550866976,65.51214636478207,46.49515449133023,19.01699187345183,34.48785363521794
08010405,08,01,04,05,8811,4223,6096,4588,1508,2715,100.0,47.92872545681534,69.18624446714334,52.07127454318466,17.114969923958686,30.813755532856657
08010406,08,01,04,06,7100,4302,4243,2798,1445,2857,100.0,60.59154929577465,59.760563380281695,39.40845070422535,20.35211267605634,40.23943661971831
08010407,08,01,04,07,777,353,560,424,136,217,100.0,45.43114543114543,72.07207207207207,54.56885456885456,17.503217503217503,27.927927927927925
08010508,08,01,05,08,5767,4287,3639,1480,2159,2128,100.0,74.3367435408358,63.1003988208774,25.66325645916421,37.43714236171319,36.89960117912259
08010509,08,01,05,09,9172,6053,6541,3119,3422,2631,100.0,65.99433057130398,71.31487134757958,34.00566942869603,37.30920191888356,28.68512865242041
08010510,08,01,05,10,448,293,227,155,72,221,100.0,65.40178571428571,50.66964285714286,34.598214285714285,16.071428571428573,49.330357142857146
08020619,08,02,06,19,11672,6596,7699,5076,2623,3973,100.0,56.511309115832766,65.96127484578477,43.488690884167234,22.472583961617545,34.038725154215214
08020620,08,02,06,20,9329,4380,7151,4949,2202,2178,100.0,46.95036981455676,76.6534462428985,53.04963018544324,23.603816057455244,23.346553757101514
08020621,08,02,06,21,2341,627,2144,1714,430,197,100.0,26.783425886373347,91.58479282357966,73.21657411362665,18.36821870995301,8.415207176420333
08020622,08,02,06,22,14254,4234,12305,10020,2285,1949,100.0,29.70394275291146,86.32664515223797,70.29605724708854,16.03058790514943,13.673354847762031
08020623,08,02,06,23,1253,419,1069,834,235,184,100.0,33.43974461292897,85.31524341580207,66.56025538707104,18.754988028731045,14.684756584197926
08020624,08,02,06,24,1404,528,1220,876,344,184,100.0,37.60683760683761,86.8945868945869,62.39316239316239,24.501424501424502,13.105413105413104
08020625,08,02,06,25,3321,1072,2786,2249,537,535,100.0,32.27943390545017,83.89039445950016,67.72056609454984,16.169828364950316,16.10960554049985
08020726,08,02,07,26,8320,2339,7320,5981,1339,1000,100.0,28.112980769230766,87.98076923076923,71.88701923076923,16.09375,12.01923076923077
08020727,08,02,07,27,11578,3628,10034,7950,2084,1544,100.0,31.335291069269307,86.66436344791848,68.6647089307307,17.999654517187768,13.335636552081533
08020728,08,02,07,28,8698,4052,6679,4646,2033,2019,100.0,46.58542193607726,76.78776730282823,53.41457806392275,23.373189238905496,23.212232697171764
08030829,08,03,08,29,12534,6603,9848,5931,3917,2686,100.0,52.68070847295356,78.57028881442476,47.31929152704643,31.25099728737833,21.429711185575233
08030830,08,03,08,30,7303,3194,6017,4109,1908,1286,100.0,43.73545118444475,82.39079830206765,56.26454881555525,26.126249486512393,17.609201697932356
08030831,08,03,08,31,17754,9538,13799,8216,5583,3955,100.0,53.723104652472685,77.72332995381322,46.27689534752732,31.446434606285905,22.276670046186776
08040932,08,04,09,32,2834,943,2451,1891,560,383,100.0,33.27452364149612,86.48553281580804,66.72547635850388,19.760056457304167,13.514467184191956
08040933,08,04,09,33,4103,1421,3505,2682,823,598,100.0,34.633195223007554,85.42529856202779,65.36680477699245,20.05849378503534,14.574701437972216
08040934,08,04,09,34,2661,930,2255,1731,524,406,100.0,34.94926719278467,84.74257797820368,65.05073280721533,19.69184517098835,15.257422021796316
08041035,08,04,10,35,8264,3004,6974,5260,1714,1290,100.0,36.35043562439497,84.39012584704744,63.64956437560504,20.7405614714424,15.609874152952566
08041036,08,04,10,36,6844,1783,6125,5061,1064,719,100.0,26.052016364699004,89.49444769140852,73.947983635301,15.54646405610754,10.505552308591467
08041037,08,04,10,37,9997,3006,8570,6991,1579,1427,100.0,30.069020706211862,85.7257177153146,69.93097929378813,15.794738421526459,14.274282284685405
08041038,08,04,10,38,7118,1769,6535,5349,1186,583,100.0,24.85248665355437,91.80949704973307,75.14751334644562,16.66198370328744,8.190502950266929
08041039,08,04,10,39,3776,1131,3371,2645,726,405,100.0,29.952330508474578,89.27436440677965,70.04766949152543,19.226694915254235,10.725635593220339
08041040,08,04,10,40,7951,2150,7067,5801,1266,884,100.0,27.040623820903033,88.8819016475915,72.95937617909696,15.922525468494527,11.118098352408502
09010101,09,01,01,01,13104,4356,10506,8748,1758,2598,100.0,33.24175824175824,80.17399267399267,66.75824175824175,13.415750915750916,19.826007326007325
09010102,09,01,01,02,63,13,54,50,4,9,100.0,20.634920634920633,85.71428571428571,79.36507936507937,6.349206349206349,14.285714285714285
09010201,09,01,02,01,4375,855,3912,3520,392,463,100.0,19.54285714285714,89.41714285714286,80.45714285714286,8.959999999999999,10.582857142857142
09010202,09,01,02,02,6924,1374,6033,5550,483,891,100.0,19.844020797227035,87.1317157712305,80.15597920277297,6.975736568457538,12.868284228769497
09010301,09,01,03,01,15796,2855,14089,12941,1148,1707,100.0,18.074195998987086,89.19346670043049,81.92580400101292,7.267662699417573,10.80653329956951
09010302,09,01,03,02,3098,951,2565,2147,418,533,100.0,30.69722401549387,82.7953518398967,69.30277598450614,13.492575855390573,17.204648160103293
09010401,09,01,04,01,8480,1093,7845,7387,458,635,100.0,12.889150943396228,92.51179245283019,87.11084905660378,5.400943396226415,7.488207547169812
09010402,09,01,04,02,11480,1988,10470,9492,978,1010,100.0,17.317073170731707,91.2020905923345,82.68292682926828,8.519163763066203,8.797909407665506
09020501,09,02,05,01,7535,2458,5686,5077,609,1849,100.0,32.621101526211014,75.46118115461181,67.37889847378898,8.082282680822827,24.53881884538819
09020502,09,02,05,02,16103,3912,13431,12191,1240,2672,100.0,24.293609886356577,83.40681860522884,75.70639011364342,7.700428491585419,16.59318139477116
09020601,09,02,06,01,9424,2986,7123,6438,685,2301,100.0,31.685059422750424,75.58361629881153,68.31494057724957,7.268675721561969,24.416383701188455
09020602,09,02,06,02,3580,346,3385,3234,151,195,100.0,9.664804469273742,94.55307262569832,90.33519553072625,4.217877094972067,5.4469273743016755
09020701,09,02,07,01,3059,1289,2094,1770,324,965,100.0,42.13795357960118,68.4537430532854,57.862046420398826,10.591696632886565,31.546256946714614
09020702,09,02,07,02,17151,3500,14677,13651,1026,2474,100.0,20.406973354323362,85.57518512040114,79.59302664567663,5.982158474724506,14.424814879598857
09020801,09,02,08,01,3061,359,2830,2702,128,231,100.0,11.728193400849396,92.45344658608298,88.27180659915061,4.181639986932375,7.54655341391702
09020802,09,02,08,02,8292,1881,6949,6411,538,1343,100.0,22.68451519536903,83.803666184274,77.31548480463097,6.488181379643029,16.196333815726003
09030901,09,03,09,01,14458,2347,13377,12111,1266,1081,100.0,16.23322727901508,92.5231705630101,83.76677272098492,8.756397842025176,7.4768294369899015
09030902,09,03,09,02,5660,1055,5010,4605,405,650,100.0,18.639575971731446,88.51590106007066,81.36042402826855,7.1554770318021195,11.484098939929329
09030903,09,03,09,03,8169,1717,7378,6452,926,791,100.0,21.018484514628476,90.31705227077977,78.98151548537152,11.335536785408252,9.682947729220222
09031001,09,03,10,01,13167,1841,12088,11326,762,1079,100.0,13.981924508240299,91.80527075263917,86.0180754917597,5.7871952608794714,8.194729247360828
09031101,09,03,11,01,7217,1127,6551,6090,461,666,100.0,15.615906886517944,90.77178883192462,84.38409311348207,6.387695718442567,9.228211168075378
09031201,09,03,12,01,1871,196,1796,1675,121,75,100.0,10.47568145376804,95.99144842330305,89.52431854623197,6.467129877071084,4.008551576696953
09031202,09,03,12,02,2571,281,2431,2290,141,140,100.0,10.929599377674057,94.55464799688838,89.07040062232593,5.484247374562427,5.44535200311163
09041301,09,04,13,01,10138,726,9774,9412,362,364,100.0,7.16117577431446,96.40954823436574,92.83882422568553,3.570724008680213,3.590451765634248
09041302,09,04,13,02,1911,210,1810,1701,109,101,100.0,10.989010989010989,94.71480900052327,89.01098901098901,5.703819989534275,5.285190999476714
09041401,09,04,14,01,5445,505,5225,4940,285,220,100.0,9.274563820018365,95.95959595959596,90.72543617998163,5.234159779614325,4.040404040404041
09041402,09,04,14,02,1569,253,1429,1316,113,140,100.0,16.12492033142129,91.07711918419376,83.8750796685787,7.202039515615041,8.922880815806247
09041403,09,04,14,03,4368,595,3966,3773,193,402,100.0,13.62179487179487,90.7967032967033,86.37820512820514,4.418498168498169,9.203296703296704
09041501,09,04,15,01,7337,1501,6364,5836,528,973,100.0,20.45795284176094,86.73844895733951,79.54204715823906,7.19640179910045,13.261551042660487
09041601,09,04,16,01,6867,601,6604,6266,338,263,100.0,8.75200232998398,96.17008883063929,91.24799767001602,4.922091160623271,3.8299111693607104
09051701,09,05,17,01,4062,472,3756,3590,166,306,100.0,11.619891678975874,92.46676514032495,88.38010832102412,4.0866568193008375,7.533234859675036
09051702,09,05,17,02,14947,1309,14309,13638,671,638,100.0,8.75761022278718,95.73158493343146,91.24238977721282,4.489195156218639,4.268415066568542
09051801,09,05,18,01,9856,1022,9315,8834,481,541,100.0,10.369318181818182,94.51095779220779,89.63068181818183,4.880275974025975,5.489042207792208
09051901,09,05,19,01,11733,1832,10531,9901,630,1202,100.0,15.614079945452996,89.7553907781471,84.385920054547,5.369470723600102,10.244609221852894
09052001,09,05,20,01,13294,1294,12576,12000,576,718,100.0,9.733714457650068,94.59906724838272,90.26628554234993,4.332781706032797,5.400932751617271
10010101,10,01,01,01,5709,1600,4804,4109,695,905,100.0,28.025923979681206,84.14783674899282,71.9740760203188,12.173760728674024,15.852163251007182
10010102,10,01,01,02,18613,5123,15948,13490,2458,2665,100.0,27.523773706549186,85.68205017998173,72.47622629345082,13.205823886530919,14.317949820018267
10010203,10,01,02,03,1262,836,482,426,56,780,100.0,66.24405705229795,38.193343898573694,33.75594294770206,4.437400950871632,61.806656101426306
10010204,10,01,02,04,10586,2735,9184,7851,1333,1402,100.0,25.83600982429624,86.75609295295673,74.16399017570376,12.592102777252975,13.243907047043265
10010205,10,01,02,05,8198,1450,7335,6748,587,863,100.0,17.687240790436693,89.47304220541595,82.31275920956331,7.160282995852647,10.526957794584044
10010206,10,01,02,06,17316,4469,14718,12847,1871,2598,100.0,25.808500808500806,84.996534996535,74.19149919149919,10.805035805035805,15.003465003465003
10010207,10,01,02,07,10782,2877,9353,7905,1448,1429,100.0,26.683361157484697,86.74642923390836,73.3166388425153,13.429790391393063,13.253570766091634
10010308,10,01,03,08,2228,659,1846,1569,277,382,100.0,29.578096947935368,82.85457809694793,70.42190305206462,12.432675044883304,17.145421903052064
10010309,10,01,03,09,14860,3948,12907,10912,1995,1953,100.0,26.567967698519517,86.85733512786003,73.43203230148049,13.425302826379543,13.142664872139973
10010310,10,01,03,10,18273,4546,15913,13727,2186,2360,100.0,24.878235648224155,87.08476987905654,75.12176435177584,11.963005527280687,12.91523012094347
10010311,10,01,03,11,3681,535,3498,3146,352,183,100.0,14.534093996196686,95.02852485737571,85.46590600380331,9.562618853572399,4.9714751426242865
10020412,10,02,04,12,7171,2411,5793,4760,1033,1378,100.0,33.621531167201226,80.7837121740343,66.37846883279877,14.405243341235533,19.216287825965694
10020413,10,02,04,13,16168,4039,13324,12129,1195,2844,100.0,24.98144482929243,82.40969816922316,75.01855517070757,7.391142998515586,17.590301830776845
10020414,10,02,04,14,1716,847,1231,869,362,485,100.0,49.358974358974365,71.73659673659674,50.641025641025635,21.095571095571096,28.263403263403262
10020415,10,02,04,15,6503,2463,4528,4040,488,1975,100.0,37.87482700292173,69.62940181454714,62.12517299707827,7.504228817468861,30.37059818545287
10020416,10,02,04,16,5929,1886,4626,4043,583,1303,100.0,31.809748692865575,78.02327542587282,68.19025130713442,9.833024118738404,21.97672457412717
10020517,10,02,05,17,9975,1874,8748,8101,647,1227,100.0,18.786967418546364,87.69924812030075,81.21303258145363,6.486215538847118,12.300751879699249
10020518,10,02,05,18,5317,1338,4381,3979,402,936,100.0,25.164566484859886,82.3960880195599,74.83543351514011,7.5606545044197855,17.6039119804401
10020519,10,02,05,19,6111,2081,4663,4030,633,1448,100.0,34.053346424480445,76.30502372770414,65.94665357551955,10.358370152184586,23.694976272295857
10020620,10,02,06,20,3465,707,3073,2758,315,392,100.0,20.404040404040405,88.68686868686869,79.5959595959596,9.090909090909092,11.313131313131313
10020621,10,02,06,21,6342,1532,5336,4810,526,1006,100.0,24.156417533900978,84.13749605802586,75.84358246609902,8.293913591926836,15.86250394197414
10020622,10,02,06,22,8919,1516,8092,7403,689,827,100.0,16.997421235564524,90.72766005157528,83.00257876443547,7.725081287139814,9.272339948424712
10020623,10,02,06,23,6487,915,6054,5572,482,433,100.0,14.105133343610298,93.32511176198551,85.8948666563897,7.430245105595806,6.674888238014491
10030724,10,03,07,24,7805,1435,6909,6370,539,896,100.0,18.385650224215247,88.5201793721973,81.61434977578476,6.9058295964125564,11.47982062780269
10030725,10,03,07,25,6952,1652,5966,5300,666,986,100.0,23.76294591484465,85.81703107019563,76.23705408515535,9.579976985040275,14.182968929804375
10030726,10,03,07,26,3938,722,3571,3216,355,367,100.0,18.334179786693753,90.68054850177755,81.66582021330625,9.014728288471305,9.319451498222447
10030727,10,03,07,27,10260,1239,9760,9021,739,500,100.0,12.076023391812866,95.12670565302143,87.92397660818713,7.2027290448343075,4.8732943469785575
10040828,10,04,08,28,7807,740,7455,7067,388,352,100.0,9.47867298578199,95.49122582297937,90.52132701421802,4.969898808761368,4.508774177020623
10040829,10,04,08,29,3868,429,3611,3439,172,257,100.0,11.09100310237849,93.35573940020683,88.9089968976215,4.446742502585315,6.644260599793175
10040830,10,04,08,30,7733,571,7550,7162,388,183,100.0,7.383938962886331,97.63351868615027,92.61606103711367,5.017457649036596,2.366481313849735
10040931,10,04,09,31,9921,908,9558,9013,545,363,100.0,9.152303195242414,96.34109464771696,90.84769680475759,5.4933978429593795,3.658905352283036
10040932,10,04,09,32,4457,519,4185,3938,247,272,100.0,11.644603993717748,93.89724029616335,88.35539600628225,5.541844289881086,6.102759703836661
10040933,10,04,09,33,15379,1233,14880,14146,734,499,100.0,8.017426360621627,96.75531569022692,91.98257363937837,4.77274205084856,3.2446843097730675
11010101,11,01,01,01,649,84,592,565,27,57,100.0,12.942989214175654,91.21725731895224,87.05701078582435,4.160246533127889,8.782742681047766
11010102,11,01,01,02,2653,193,2565,2460,105,88,100.0,7.274783264229175,96.68300037693177,92.72521673577081,3.95778364116095,3.3169996230682246
11010103,11,01,01,03,2189,728,1631,1461,170,558,100.0,33.25719506624029,74.5089081772499,66.7428049337597,7.766103243490178,25.49109182275011
11010204,11,01,02,04,8986,2976,7107,6010,1097,1879,100.0,33.11818384153128,79.08969508123748,66.88181615846874,12.207878922768751,20.91030491876252
11010205,11,01,02,05,7052,2377,5540,4675,865,1512,100.0,33.706749858196254,78.55927396483267,66.29325014180374,12.266023823028927,21.44072603516733
11010206,11,01,02,06,6095,1733,4943,4362,581,1152,100.0,28.433141919606236,81.09926168990977,71.56685808039377,9.532403609515997,18.900738310090237
11010207,11,01,02,07,7609,2212,6023,5397,626,1586,100.0,29.070837166513343,79.15626232093574,70.92916283348666,8.227099487449072,20.84373767906427
11010308,11,01,03,08,11690,3570,9572,8120,1452,2118,100.0,30.538922155688624,81.8819503849444,69.46107784431138,12.42087254063302,18.118049615055604
11010309,11,01,03,09,9583,2768,7858,6815,1043,1725,100.0,28.884482938536994,81.99937389126578,71.11551706146301,10.883856829802776,18.000626108734217
11010310,11,01,03,10,5825,1267,4959,4558,401,866,100.0,21.751072961373392,85.13304721030043,78.24892703862662,6.88412017167382,14.86695278969957
11020411,11,02,04,11,9998,3074,7743,6924,819,2255,100.0,30.74614922984597,77.44548909781956,69.25385077015403,8.191638327665533,22.554510902180436
11020412,11,02,04,12,6856,1616,5868,5240,628,988,100.0,23.570595099183198,85.58926487747958,76.4294049008168,9.159859976662778,14.410735122520421
11020513,11,02,05,13,3898,819,3286,3079,207,612,100.0,21.010774756285276,84.29964084145716,78.98922524371473,5.310415597742432,15.700359158542842
11020514,11,02,05,14,9897,2655,7870,7242,628,2027,100.0,26.82631100333434,79.51904617560876,73.17368899666565,6.3453571789431145,20.48095382439123
11020515,11,02,05,15,15296,4494,12516,10802,1714,2780,100.0,29.38023012552301,81.82531380753139,70.61976987447699,11.205543933054393,18.17468619246862
11020516,11,02,05,16,4125,844,3696,3281,415,429,100.0,20.46060606060606,89.60000000000001,79.53939393939395,10.06060606060606,10.4
11030617,11,03,06,17,6058,2198,4741,3860,881,1317,100.0,36.28260151865302,78.26015186530208,63.717398481346976,14.542753383955102,21.73984813469792
11030618,11,03,06,18,16427,4960,13291,11467,1824,3136,100.0,30.194192487977112,80.90947829792415,69.8058075120229,11.10367078590126,19.09052170207585
11030619,11,03,06,19,11266,3811,8934,7455,1479,2332,100.0,33.827445410971066,79.3005503284218,66.17255458902893,13.127995739392864,20.6994496715782
11030720,11,03,07,20,6359,3600,3176,2759,417,3183,100.0,56.61267494889134,49.94495989935525,43.38732505110867,6.55763484824658,50.05504010064475
11030721,11,03,07,21,25044,6832,20499,18212,2287,4545,100.0,27.279987222488423,81.85194058457115,72.72001277751158,9.131927807059576,18.148059415428847
11030824,11,03,08,24,9956,3763,7591,6193,1398,2365,100.0,37.796303736440336,76.24548011249497,62.203696263559664,14.041783848935316,23.754519887505023
11040925,11,04,09,25,4218,1043,3538,3175,363,680,100.0,24.727358937885256,83.87861545756282,75.27264106211474,8.60597439544808,16.121384542437173
11040926,11,04,09,26,29849,7406,24866,22443,2423,4983,100.0,24.81155147576133,83.30597339944387,75.18844852423867,8.1175248752052,16.694026600556132
11041022,11,04,10,22,5824,2133,4277,3691,586,1547,100.0,36.62431318681318,73.4375,63.37568681318682,10.061813186813188,26.5625
11041023,11,04,10,23,6756,2506,5279,4250,1029,1477,100.0,37.092954410894016,78.13795145056245,62.907045589105984,15.230905861456485,21.86204854943754
11041027,11,04,10,27,3195,995,2538,2200,338,657,100.0,31.142410015649453,79.43661971830987,68.85758998435054,10.579029733959311,20.56338028169014
11041128,11,04,11,28,27002,7772,22097,19230,2867,4905,100.0,28.78305310717725,81.83467891267313,71.21694689282275,10.617732019850381,18.165321087326863
11051229,11,05,12,29,4244,962,3692,3282,410,552,100.0,22.667295004712535,86.99340245051837,77.33270499528746,9.660697455230913,13.006597549481622
11051330,11,05,13,30,10346,2345,8718,8001,717,1628,100.0,22.66576454668471,84.26445002899672,77.33423545331529,6.930214575681423,15.735549971003287
11051331,11,05,13,31,10640,1410,9950,9230,720,690,100.0,13.25187969924812,93.51503759398496,86.74812030075188,6.7669172932330826,6.484962406015038
11051332,11,05,13,32,7252,1088,6670,6164,506,582,100.0,15.002757859900717,91.9746276889134,84.99724214009929,6.97738554881412,8.025372311086597
12103115,12,10,31,15,7702,3446,5708,4256,1452,1994,100.0,44.741625551804724,74.1106206180213,55.25837444819527,18.85224616982602,25.889379381978706
12103116,12,10,31,16,9986,5025,6879,4961,1918,3107,100.0,50.320448628079305,68.88644101742439,49.67955137192069,19.206889645503704,31.113558982575608
12103117,12,10,31,17,10985,6043,7296,4942,2354,3689,100.0,55.01137915339098,66.41784251251707,44.98862084660901,21.429221665908056,33.58215748748293
12103218,12,10,32,18,14057,6520,10306,7537,2769,3751,100.0,46.38258518887387,73.31578572952976,53.61741481112613,19.698370918403644,26.68421427047023
12103219,12,10,32,19,8869,4188,6536,4681,1855,2333,100.0,47.22065621828842,73.69489232156951,52.77934378171159,20.91554853985793,26.30510767843049
12103220,12,10,32,20,4661,1515,3859,3146,713,802,100.0,32.50375455910749,82.79339197597082,67.49624544089251,15.29714653507831,17.20660802402918
12214125,12,21,41,25,7783,2612,6379,5171,1208,1404,100.0,33.560323782603106,81.96068354105101,66.4396762173969,15.521007323654118,18.039316458948992
12214126,12,21,41,26,8091,3329,6316,4762,1554,1775,100.0,41.14448152267952,78.06204424669386,58.85551847732048,19.20652576937338,21.93795575330614
12214421,12,21,44,21,2753,1099,2070,1654,416,683,100.0,39.92008717762441,75.1907010533963,60.07991282237559,15.110788231020706,24.809298946603704
12214422,12,21,44,22,8270,4990,5295,3280,2015,2975,100.0,60.338573155985486,64.02660217654172,39.66142684401451,24.365175332527205,35.97339782345828
12214423,12,21,44,23,5667,2444,4381,3223,1158,1286,100.0,43.12687488971237,77.30721722251633,56.873125110287624,20.43409211222869,22.69278277748368
12214424,12,21,44,24,11022,5976,7288,5046,2242,3734,100.0,54.21883505715841,66.12230085283977,45.78116494284159,20.341135909998183,33.87769914716022
12214527,12,21,45,27,10959,2657,9431,8302,1129,1528,100.0,24.2449128570125,86.05712200018249,75.75508714298749,10.302034857195,13.942877999817501
12214528,12,21,45,28,266,105,198,161,37,68,100.0,39.473684210526315,74.43609022556392,60.526315789473685,13.909774436090224,25.563909774436087
12224229,12,22,42,29,6011,854,5660,5157,503,351,100.0,14.207286641157877,94.16070537348195,85.79271335884212,8.367992014639828,5.8392946265180505
12224230,12,22,42,30,18099,2584,17091,15515,1576,1008,100.0,14.277031880214377,94.43063152660368,85.72296811978562,8.707663406818057,5.56936847339632
12231101,12,23,11,01,16726,2555,15535,14171,1364,1191,100.0,15.275618797082386,92.87934951572402,84.72438120291761,8.154968312806409,7.120650484275977
12231102,12,23,11,02,16689,2307,15764,14382,1382,925,100.0,13.823476541434479,94.457427047756,86.17652345856553,8.280903589190485,5.542572952243993
12301203,12,30,12,03,15001,4760,12111,10241,1870,2890,100.0,31.731217918805417,80.73461769215385,68.26878208119459,12.46583561095927,19.265382307846142
12301204,12,30,12,04,6434,1578,5670,4856,814,764,100.0,24.525955859496428,88.12558284115636,75.47404414050357,12.65153870065278,11.874417158843643
12301205,12,30,12,05,5166,983,4730,4183,547,436,100.0,19.02826171118854,91.56020131629887,80.97173828881145,10.588463027487418,8.439798683701124
12301206,12,30,12,06,5160,884,4846,4276,570,314,100.0,17.131782945736436,93.91472868217055,82.86821705426357,11.046511627906977,6.0852713178294575
12302107,12,30,21,07,3065,1320,2512,1745,767,553,100.0,43.066884176182704,81.95758564437195,56.933115823817296,25.02446982055465,18.042414355628058
12302108,12,30,21,08,14788,6741,11418,8047,3371,3370,100.0,45.58425750608602,77.21125236678388,54.41574249391399,22.795509872869896,22.788747633216122
12302109,12,30,21,09,11610,6118,8553,5492,3061,3057,100.0,52.69595176571921,73.66925064599484,47.30404823428079,26.36520241171404,26.330749354005167
12302110,12,30,21,10,10656,6157,7409,4499,2910,3247,100.0,57.77965465465466,69.52890390390391,42.22034534534534,27.30855855855856,30.471096096096094
12302211,12,30,22,11,3310,991,2865,2319,546,445,100.0,29.939577039274923,86.5558912386707,70.06042296072508,16.49546827794562,13.444108761329304
12302212,12,30,22,12,5922,2958,4069,2964,1105,1853,100.0,49.949341438703144,68.70989530563999,50.050658561296856,18.659236744343126,31.290104694360014
12304313,12,30,43,13,6750,1868,5527,4882,645,1223,100.0,27.674074074074074,81.88148148148147,72.32592592592593,9.555555555555555,18.118518518518517
12304314,12,30,43,14,9665,1570,8893,8095,798,772,100.0,16.244180031039836,92.01241593378168,83.75581996896017,8.256595964821521,7.9875840662183135
