id,district_id,forecast_area_id,district_region_id,planning_area_id,inhabitants,inhabitants_with_migration_background,inhabitants_germans,inhabitants_germans_without_migration_background,inhabitants_germans_with_migration_background,inhabitants_foreigners,inhabitants_percentage,inhabitants_with_migration_background_percentage,inhabitants_germans_percentage,inhabitants_germans_without_migration_background_percentage,inhabitants_germans_with_migration_background_percentage,inhabitants_foreigners_percentage
01100101,01,10,01,01,3436,2092,2015,1344,671,1421,100.0,60.884749708963916,58.64377182770664,39.11525029103609,19.52852153667055,41.35622817229336
01100102,01,10,01,02,1791,1199,890,592,298,901,100.0,66.94584031267449,49.6929089893914,33.054159687325516,16.638749302065886,50.307091010608595
01100103,01,10,01,03,5251,3096,3347,2155,1192,1904,100.0,58.960198057512855,63.74023995429442,41.039801942487145,22.700438011807275,36.25976004570558
01100104,01,10,01,04,4677,3038,2847,1639,1208,1830,100.0,64.95616848407099,60.8723540731238,35.043831515929014,25.828522557194784,39.127645926876205
01100205,01,10,02,05,2732,1734,1443,998,445,1289,100.0,63.46998535871157,52.81844802342606,36.53001464128843,16.28843338213763,47.181551976573935
01100206,01,10,02,06,1823,957,1166,866,300,657,100.0,52.49588590235875,63.96050466264399,47.50411409764125,16.456390565002742,36.03949533735601
01100207,01,10,02,07,8379,4324,5496,4055,1441,2883,100.0,51.60520348490273,65.59255281059792,48.39479651509727,17.197756295500657,34.40744718940208
01100308,01,10,03,08,7032,3133,4800,3899,901,2232,100.0,44.55346985210467,68.25938566552901,55.44653014789533,12.812855517633675,31.74061433447099
01100309,01,10,03,09,12314,5046,8998,7268,1730,3316,100.0,40.97774890368686,73.07130095825889,59.02225109631314,14.049049861945754,26.928699041741105
01100310,01,10,03,10,10043,4958,6441,5085,1356,3602,100.0,49.36771880912078,64.13422284178034,50.632281190879226,13.501941650901125,35.86577715821965
01100311,01,10,03,11,9197,4254,6393,4943,1450,2804,100.0,46.254213330433835,69.51179732521474,53.745786669566165,15.766010655648582,30.48820267478526
01100312,01,10,03,12,9772,4445,6752,5327,1425,3020,100.0,45.48710601719198,69.09537453950061,54.512893982808016,14.58248055669259,30.904625460499386
01100313,01,10,03,13,10715,4941,7385,5774,1611,3330,100.0,46.112925804946336,68.92207186187588,53.887074195053664,15.03499766682221,31.077928138124122
01100414,01,10,04,14,5185,2761,3136,2424,712,2049,100.0,53.24975891996143,60.48216007714561,46.75024108003857,13.73191899710704,39.517839922854385
01100415,01,10,04,15,12666,5133,9238,7533,1705,3428,100.0,40.52581714827096,72.93541765356072,59.47418285172904,13.461234801831676,27.064582346439288
01100416,01,10,04,16,13435,5466,9785,7969,1816,3650,100.0,40.68477856345367,72.8321548195013,59.31522143654634,13.516933382954969,27.167845180498695
01200517,01,20,05,17,3723,2176,2214,1547,667,1509,100.0,58.44748858447488,59.46817082997583,41.55251141552511,17.91565941445071,40.531829170024174
01200518,01,20,05,18,6851,4341,3837,2510,1327,3014,100.0,63.36301269887608,56.006422420084654,36.63698730112392,19.369435118960734,43.99357757991534
01200519,01,20,05,19,9097,4912,5774,4185,1589,3323,100.0,53.99582279872486,63.47147411234473,46.00417720127515,17.46729691106958,36.52852588765527
01200520,01,20,05,20,9375,4513,6601,4862,1739,2774,100.0,48.138666666666666,70.41066666666667,51.861333333333334,18.549333333333333,29.589333333333336
01200521,01,20,05,21,5208,3070,3275,2138,1137,1933,100.0,58.94777265745008,62.88402457757296,41.05222734254993,21.831797235023043,37.115975422427034
01200522,01,20,05,22,11365,4042,9079,7323,1756,2286,100.0,35.565332160140784,79.88561372635283,64.43466783985922,15.450945886493619,20.11438627364716
01200623,01,20,06,23,10763,5439,7461,5324,2137,3302,100.0,50.534237666078226,69.32082133234229,49.465762333921774,19.855058998420514,30.679178667657713
01200624,01,20,06,24,5709,3896,3026,1813,1213,2683,100.0,68.24312489052373,53.00402872657208,31.75687510947627,21.24715361709581,46.99597127342792
01200625,01,20,06,25,6910,4133,4561,2777,1784,2349,100.0,59.81186685962373,66.00578871201158,40.188133140376266,25.817655571635314,33.99421128798842
01200626,01,20,06,26,5873,2503,4373,3370,1003,1500,100.0,42.618763834496846,74.45939043078495,57.38123616550315,17.078154265281796,25.54060956921505
01200627,01,20,06,27,3263,2098,2188,1165,1023,1075,100.0,64.29665951578302,67.0548574931045,35.70334048421698,31.351517008887527,32.9451425068955
01200628,01,20,06,28,3182,1386,2414,1796,618,768,100.0,43.55751099937146,75.86423632935261,56.44248900062854,19.421747328724074,24.135763670647393
01200629,01,20,06,29,5913,2862,3874,3051,823,2039,100.0,48.401826484018265,65.51665821072213,51.598173515981735,13.918484694740402,34.48334178927786
01300730,01,30,07,30,7990,5725,4234,2265,1969,3756,100.0,71.6520650813517,52.99123904881101,28.34793491864831,24.6433041301627,47.00876095118899
01300731,01,30,07,31,8533,4962,5332,3571,1761,3201,100.0,58.15070901207079,62.48681589124575,41.849290987929216,20.637524903316535,37.51318410875425
01300732,01,30,07,32,9837,6128,5949,3709,2240,3888,100.0,62.29541526888279,60.47575480329369,37.70458473111721,22.771170072176478,39.52424519670632
01300733,01,30,07,33,11523,7082,7160,4441,2719,4363,100.0,61.45968931701814,62.13659637247244,38.54031068298186,23.596285689490585,37.86340362752755
01300834,01,30,08,34,14263,9475,9902,4788,5114,4361,100.0,66.43062469326229,69.42438477178715,33.56937530673771,35.855009465049434,30.57561522821286
01300835,01,30,08,35,10426,6195,7255,4231,3024,3171,100.0,59.41876079033186,69.58565125647421,40.581239209668134,29.00441204680606,30.4143487435258
01300836,01,30,08,36,14594,9425,8750,5169,3581,5844,100.0,64.58133479512128,59.956146361518435,35.41866520487872,24.537481156639714,40.04385363848157
01400937,01,40,09,37,10640,5169,7512,5471,2041,3128,100.0,48.580827067669176,70.6015037593985,51.419172932330824,19.18233082706767,29.398496240601503
01400938,01,40,09,38,9708,5113,6367,4595,1772,3341,100.0,52.667902760609806,65.58508446641945,47.332097239390194,18.252987227029255,34.414915533580555
01400939,01,40,09,39,5921,3056,3796,2865,931,2125,100.0,51.61290322580645,64.11079209592974,48.38709677419355,15.723695321736193,35.88920790407026
01400940,01,40,09,40,6748,2461,5635,4287,1348,1113,100.0,36.47006520450503,83.50622406639005,63.52993479549496,19.97628927089508,16.493775933609957
01400941,01,40,09,41,3761,1678,2822,2083,739,939,100.0,44.61579367189577,75.0332358415315,55.38420632810423,19.64902951342728,24.966764158468493
01400942,01,40,09,42,8599,4626,5451,3973,1478,3148,100.0,53.796953134085356,63.3910919874404,46.203046865914644,17.188045121525757,36.608908012559596
01401043,01,40,10,43,7627,5113,4521,2514,2007,3106,100.0,67.03815392683886,59.27625540841747,32.96184607316114,26.31440933525633,40.72374459158253
01401044,01,40,10,44,10115,6825,5682,3290,2392,4433,100.0,67.47404844290658,56.17399901136926,32.52595155709342,23.64804745427583,43.826000988630746
01401045,01,40,10,45,5667,4121,3090,1546,1544,2577,100.0,72.71925180871713,54.526204340921126,27.280748191282868,27.245456149638258,45.473795659078874
01401046,01,40,10,46,8745,4359,5967,4386,1581,2778,100.0,49.84562607204116,68.23327615780445,50.15437392795883,18.078902229845625,31.76672384219554
01401047,01,40,10,47,7945,5552,3891,2393,1498,4054,100.0,69.88042794210195,48.97419760855884,30.119572057898047,18.854625550660792,51.025802391441154
01401048,01,40,10,48,9181,5478,5664,3703,1961,3517,100.0,59.666702973532296,61.692626075590894,40.333297026467704,21.35932904912319,38.307373924409106
01401049,01,40,10,49,6666,4031,3877,2635,1242,2789,100.0,60.47104710471047,58.16081608160816,39.52895289528953,18.631863186318633,41.83918391839184
02100101,02,10,01,01,6257,4352,3750,1905,1845,2507,100.0,69.5540994086623,59.93287517979863,30.445900591337704,29.486974588460924,40.06712482020137
02100102,02,10,01,02,8633,6069,5629,2564,3065,3004,100.0,70.30001158345883,65.20328970230511,29.699988416541178,35.503301285763925,34.796710297694894
02100103,02,10,01,03,5385,3401,3668,1984,1684,1717,100.0,63.156917363045494,68.11513463324049,36.843082636954506,31.27205199628598,31.88486536675952
02100104,02,10,01,04,5587,3842,3513,1745,1768,2074,100.0,68.76678002505817,62.87810989797745,31.23321997494183,31.644889923035617,37.121890102022554
02100105,02,10,01,05,9527,6743,6237,2784,3453,3290,100.0,70.77778944053742,65.46656869948568,29.22221055946258,36.244358140023095,34.53343130051433
02100106,02,10,01,06,5028,3245,3403,1783,1620,1625,100.0,64.53858392999204,67.68098647573588,35.46141607000796,32.21957040572792,32.31901352426412
02200207,02,20,02,07,2083,837,1601,1246,355,482,100.0,40.182429188670184,76.86029764762363,59.817570811329816,17.042726836293806,23.13970235237638
02200208,02,20,02,08,5922,2585,4276,3337,939,1646,100.0,43.65079365079365,72.20533603512327,56.34920634920635,15.856129685916919,27.794663964876733
02200209,02,20,02,09,10906,4463,8201,6443,1758,2705,100.0,40.922428021272694,75.19713918943701,59.077571978727306,16.1195672107097,24.802860810562994
02200210,02,20,02,10,12299,5358,8932,6941,1991,3367,100.0,43.564517440442316,72.62379055207741,56.43548255955769,16.188307992519718,27.376209447922594
02200211,02,20,02,11,14747,6160,11126,8587,2539,3621,100.0,41.77120770326168,75.44585339391062,58.22879229673832,17.217061097172305,24.554146606089375
02200212,02,20,02,12,8528,4292,6238,4236,2002,2290,100.0,50.32833020637899,73.14727954971858,49.671669793621014,23.47560975609756,26.852720450281424
02200213,02,20,02,13,10185,4633,7226,5552,1674,2959,100.0,45.48846342660776,70.94747177221404,54.51153657339224,16.435935198821795,29.052528227785963
02300314,02,30,03,14,7502,4541,4763,2961,1802,2739,100.0,60.53052519328179,63.489736070381234,39.46947480671821,24.020261263663023,36.510263929618766
02300315,02,30,03,15,8626,4921,5686,3705,1981,2940,100.0,57.048458149779734,65.9169951309993,42.951541850220266,22.96545328077904,34.083004869000696
02300316,02,30,03,16,4214,2076,2973,2138,835,1241,100.0,49.26435690555292,70.55054579971524,50.73564309444708,19.814902705268153,29.449454200284762
02300417,02,30,04,17,8268,4516,5481,3752,1729,2787,100.0,54.62022254475085,66.29172714078373,45.379777455249155,20.91194968553459,33.70827285921625
02300418,02,30,04,18,7705,3673,5398,4032,1366,2307,100.0,47.67034393251136,70.0584036340039,52.32965606748864,17.72874756651525,29.941596365996105
02300419,02,30,04,19,10728,5462,7193,5266,1927,3535,100.0,50.91349739000746,67.04884414615958,49.08650260999254,17.962341536167038,32.95115585384042
02400520,02,40,05,20,5641,1864,4505,3777,728,1136,100.0,33.04378656266619,79.86172664421201,66.95621343733382,12.905513206878213,20.13827335578798
02400521,02,40,05,21,7799,2649,6105,5150,955,1694,100.0,33.96589306321323,78.27926657263752,66.03410693678676,12.245159635850749,21.720733427362482
02400522,02,40,05,22,11268,3336,9106,7932,1174,2162,100.0,29.605963791267303,80.81292154774583,70.39403620873269,10.418885339013134,19.187078452254173
02400623,02,40,06,23,13331,6094,9329,7237,2092,4002,100.0,45.712999774960615,69.97974645562974,54.287000225039385,15.692746230590354,30.020253544370263
02400624,02,40,06,24,11270,3759,8545,7511,1034,2725,100.0,33.35403726708074,75.82076308784383,66.64596273291924,9.174800354924578,24.179236912156167
02400625,02,40,06,25,1119,767,446,352,94,673,100.0,68.54334226988382,39.85701519213583,31.456657730116177,8.40035746201966,60.14298480786417
02500726,02,50,07,26,9116,3313,6798,5803,995,2318,100.0,36.342694164107066,74.57218078104432,63.65730583589293,10.914874945151382,25.427819218955683
02500727,02,50,07,27,6567,2343,4928,4224,704,1639,100.0,35.678391959798994,75.04187604690117,64.321608040201,10.720268006700168,24.958123953098827
02500728,02,50,07,28,10078,3342,7718,6736,982,2360,100.0,33.16134153601905,76.58265528874777,66.83865846398095,9.74399682476682,23.417344711252234
02500729,02,50,07,29,5436,1834,4245,3602,643,1191,100.0,33.738042678440024,78.09050772626932,66.26195732155998,11.828550404709345,21.909492273730685
02500830,02,50,08,30,3928,1523,2858,2405,453,1070,100.0,38.77291242362526,72.75967413441956,61.22708757637475,11.532586558044807,27.240325865580452
02500831,02,50,08,31,7910,3035,5737,4875,862,2173,100.0,38.36915297092288,72.5284450063211,61.63084702907712,10.897597977243995,27.471554993678886
02500832,02,50,08,32,9029,3801,6293,5228,1065,2736,100.0,42.0976852364603,69.69764093476576,57.90231476353971,11.79532617122605,30.302359065234246
02500833,02,50,08,33,10145,3811,7263,6334,929,2882,100.0,37.56530310497782,71.59191720059142,62.43469689502218,9.157220305569245,28.408082799408575
02500834,02,50,08,34,11421,3999,8672,7422,1250,2749,100.0,35.01444707118466,75.93030382628491,64.98555292881534,10.944750897469573,24.069696173715087
02500835,02,50,08,35,7930,3123,5687,4807,880,2243,100.0,39.382093316519544,71.71500630517023,60.61790668348045,11.097099621689786,28.284993694829762
02500836,02,50,08,36,4788,1108,4260,3680,580,528,100.0,23.141186299081035,88.97243107769424,76.85881370091896,12.11361737677527,11.027568922305765
03100101,03,10,01,01,4536,761,4038,3775,263,498,100.0,16.77689594356261,89.02116402116403,83.22310405643739,5.798059964726631,10.978835978835978
03100102,03,10,01,02,3173,819,2555,2354,201,618,100.0,25.811534825086667,80.52316419791995,74.18846517491333,6.334699023006618,19.47683580208005
03100103,03,10,01,03,8897,1566,7722,7331,391,1175,100.0,17.60143868719793,86.79330111273464,82.39856131280206,4.3947397999325615,13.20669888726537
03200204,03,20,02,04,2055,130,2003,1925,78,52,100.0,6.326034063260341,97.46958637469587,93.67396593673966,3.795620437956204,2.5304136253041363
03200205,03,20,02,05,8690,1351,7954,7339,615,736,100.0,15.546605293440738,91.53049482163406,84.45339470655927,7.077100115074798,8.469505178365939
03200206,03,20,02,06,6326,1234,5539,5092,447,787,100.0,19.506797344293393,87.55927916534935,80.49320265570661,7.066076509642744,12.440720834650648
03200207,03,20,02,07,11452,1923,10352,9529,823,1100,100.0,16.791826755151938,90.39469088368844,83.20817324484806,7.186517638840377,9.605309116311561
03200308,03,20,03,08,5223,671,4932,4552,380,291,100.0,12.847022783840705,94.42848937392303,87.1529772161593,7.275512157763737,5.571510626076967
03200309,03,20,03,09,5239,806,4803,4433,370,436,100.0,15.384615384615385,91.6778011070815,84.61538461538461,7.062416491696889,8.322198892918497
03200310,03,20,03,10,7969,1214,7442,6755,687,527,100.0,15.234031873509851,93.38687413728198,84.76596812649015,8.620906010791817,6.613125862718032
03300411,03,30,04,11,11271,2073,10074,9198,876,1197,100.0,18.392334309289325,89.37982432792121,81.60766569071068,7.77215863721054,10.620175672078787
03300412,03,30,04,12,5139,455,4939,4684,255,200,100.0,8.85386261918661,96.1081922553026,91.14613738081339,4.9620548744892,3.891807744697412
03300413,03,30,04,13,3116,262,3000,2854,146,116,100.0,8.408215661103979,96.27727856225931,91.59178433889602,4.685494223363286,3.7227214377406934
03300514,03,30,05,14,6820,552,6566,6268,298,254,100.0,8.093841642228739,96.27565982404693,91.90615835777126,4.3695014662756595,3.7243401759530794
03300515,03,30,05,15,51,7,44,44,0,7,100.0,13.725490196078432,86.27450980392157,86.27450980392157,0.0,13.725490196078432
03300516,03,30,05,16,7764,1545,6703,6219,484,1061,100.0,19.899536321483772,86.33436373003607,80.10046367851623,6.233900051519836,13.665636269963935
03300517,03,30,05,17,1110,48,1089,1062,27,21,100.0,4.324324324324325,98.1081081081081,95.67567567567568,2.4324324324324325,1.891891891891892
03400618,03,40,06,18,4835,1031,4472,3804,668,363,100.0,21.323681489141673,92.49224405377457,78.67631851085832,13.815925542916235,7.507755946225439
03400619,03,40,06,19,10366,1921,9381,8445,936,985,100.0,18.53173837545823,90.49778120779472,81.46826162454177,9.029519583252943,9.502218792205285
03400620,03,40,06,20,3534,661,3193,2873,320,341,100.0,18.704018109790603,90.35087719298247,81.29598189020939,9.054895302773062,9.649122807017543
03400721,03,40,07,21,11419,2359,10101,9060,1041,1318,100.0,20.658551536912164,88.45783343550224,79.34144846308784,9.116384972414398,11.542166564497768
03400722,03,40,07,22,3624,558,3347,3066,281,277,100.0,15.397350993377485,92.35651214128036,84.60264900662253,7.753863134657836,7.643487858719647
03400723,03,40,07,23,7051,1621,6099,5430,669,952,100.0,22.989646858601617,86.49836902567012,77.01035314139838,9.488015884271734,13.501630974329881
03400724,03,40,07,24,7588,1012,7003,6576,427,585,100.0,13.336847654190828,92.29045861887191,86.66315234580917,5.627306273062731,7.709541381128098
03400725,03,40,07,25,7423,937,6867,6486,381,556,100.0,12.622928735012797,92.50976694059005,87.37707126498721,5.132695675602856,7.490233059409943
03400826,03,40,08,26,6672,1271,5770,5401,369,902,100.0,19.049760191846524,86.48081534772182,80.95023980815348,5.530575539568345,13.519184652278177
03400827,03,40,08,27,9624,2271,8134,7353,781,1490,100.0,23.59725685785536,84.51787198669992,76.40274314214463,8.11512884455528,15.482128013300084
03400828,03,40,08,28,4806,1169,3982,3637,345,824,100.0,24.323761964211403,82.85476487723679,75.6762380357886,7.178526841448189,17.145235122763214
03400829,03,40,08,29,5529,939,4956,4590,366,573,100.0,16.98317959848074,89.63646228974498,83.01682040151927,6.619641888225719,10.363537710255018
03400830,03,40,08,30,9256,1483,8363,7773,590,893,100.0,16.022039757994815,90.35220397579948,83.9779602420052,6.374243733794295,9.647796024200519
03400831,03,40,08,31,0,0,0,0,0,0,0.0,0.0,0.0,0.0,0.0,0.0
03500932,03,50,09,32,5336,931,4633,4405,228,703,100.0,17.447526236881558,86.82533733133432,82.55247376311844,4.272863568215892,13.174662668665668
03500933,03,50,09,33,7569,1289,6751,6280,471,818,100.0,17.029990751750564,89.19275994186815,82.97000924824944,6.222750693618708,10.807240058131853
03500934,03,50,09,34,10186,2732,8347,7454,893,1839,100.0,26.82112703710976,81.9458079717259,73.17887296289024,8.766935008835656,18.0541920282741
03500935,03,50,09,35,6471,1684,5340,4787,553,1131,100.0,26.02379848555092,82.52202132591563,73.97620151444909,8.545819811466544,17.477978674084376
03500936,03,50,09,36,9797,2101,8443,7696,747,1354,100.0,21.445340410329695,86.1794426865367,78.55465958967031,7.624783096866388,13.820557313463306
03501037,03,50,10,37,8510,1653,7343,6857,486,1167,100.0,19.424206815511162,86.2867215041128,80.57579318448884,5.710928319623972,13.71327849588719
03501038,03,50,10,38,7451,1150,6642,6301,341,809,100.0,15.434169910079184,89.14239699369212,84.56583008992081,4.5765669037713055,10.857603006307878
03601139,03,60,11,39,3771,1306,2890,2465,425,881,100.0,34.632723415539644,76.63749668522938,65.36727658446036,11.270220100769027,23.36250331477062
03601140,03,60,11,40,5914,1824,4696,4090,606,1218,100.0,30.842069665201215,79.40480216435577,69.15793033479878,10.246871829556984,20.595197835644232
03601141,03,60,11,41,6547,2206,5040,4341,699,1507,100.0,33.694822055903465,76.98182373606231,66.30517794409654,10.676645791965786,23.018176263937683
03601142,03,60,11,42,10654,3762,8076,6892,1184,2578,100.0,35.31068143420312,75.80251548714098,64.68931856579688,11.113196921344096,24.19748451285902
03601243,03,60,12,43,6958,2023,5644,4935,709,1314,100.0,29.074446680080484,81.11526300661109,70.92555331991952,10.189709686691579,18.884736993388902
03601244,03,60,12,44,7549,2016,6244,5533,711,1305,100.0,26.705523910451717,82.71294211153796,73.29447608954828,9.418466021989667,17.287057888462048
03601245,03,60,12,45,12754,3476,10387,9278,1109,2367,100.0,27.254194762427474,81.44111651246668,72.74580523757253,8.69531127489415,18.558883487533322
03601346,03,60,13,46,5623,1928,4346,3695,651,1277,100.0,34.28774675440157,77.28970300551306,65.71225324559845,11.577449759914636,22.710296994486928
03601347,03,60,13,47,9433,3042,7478,6391,1087,1955,100.0,32.248489345913285,79.27488603837591,67.75151065408672,11.523375384289197,20.725113961624086
03601348,03,60,13,48,7439,2487,5780,4952,828,1659,100.0,33.431912891517676,77.69861540529641,66.56808710848232,11.130528296814088,22.30138459470359
03601449,03,60,14,49,9896,1828,8704,8068,636,1192,100.0,18.47210994341148,87.95472918350849,81.52789005658853,6.426839126919967,12.045270816491511
03601450,03,60,14,50,3971,1701,2550,2270,280,1421,100.0,42.83555779400655,64.21556283052128,57.164442205993446,7.051120624527826,35.78443716947872
03601451,03,60,14,51,6340,1910,4980,4430,550,1360,100.0,30.126182965299687,78.54889589905363,69.87381703470031,8.675078864353312,21.451104100946374
03601452,03,60,14,52,4203,1398,3235,2805,430,968,100.0,33.26195574589579,76.96883178681894,66.73804425410421,10.230787532714727,23.03116821318106
03601453,03,60,14,53,2820,836,2398,1984,414,422,100.0,29.645390070921984,85.0354609929078,70.35460992907801,14.680851063829786,14.964539007092197
03701554,03,70,15,54,11363,4340,8512,7023,1489,2851,100.0,38.194138871776815,74.90979494851712,61.805861128223185,13.103933820293937,25.090205051482883
03701555,03,70,15,55,7244,2354,5704,4890,814,1540,100.0,32.495858641634456,78.74102705687466,67.50414135836554,11.236885698509111,21.258972943125347
03701556,03,70,15,56,8645,3425,6251,5220,1031,2394,100.0,39.61827646038172,72.3076923076923,60.38172353961828,11.925968768074032,27.692307692307693
03701657,03,70,16,57,3220,1064,2488,2156,332,732,100.0,33.04347826086956,77.26708074534162,66.95652173913044,10.31055900621118,22.732919254658384
03701658,03,70,16,58,8390,2738,6545,5652,893,1845,100.0,32.63408820023838,78.00953516090584,67.36591179976162,10.64362336114422,21.99046483909416
03701659,03,70,16,59,9123,3122,7118,6001,1117,2005,100.0,34.2211991669407,78.02258029157075,65.77880083305931,12.243779458511455,21.977419708429245
03701660,03,70,16,60,12737,3607,10521,9130,1391,2216,100.0,28.3190704247468,82.60186857187722,71.68092957525319,10.92093899662401,17.39813142812279
04100101,04,10,01,01,11476,5695,8057,5781,2276,3419,100.0,49.62530498431509,70.2073893342628,50.374695015684914,19.8326943185779,29.79261066573719
04100102,04,10,01,02,7796,4373,5592,3423,2169,2204,100.0,56.092868137506414,71.72909184197025,43.907131862493586,27.821959979476656,28.270908158029755
04200203,04,20,02,03,1462,400,1249,1062,187,213,100.0,27.359781121751027,85.43091655266758,72.64021887824897,12.790697674418606,14.569083447332421
04200204,04,20,02,04,2799,876,2228,1923,305,571,100.0,31.29689174705252,79.5998570918185,68.70310825294747,10.896748838871027,20.400142908181493
04200205,04,20,02,05,2511,784,2063,1727,336,448,100.0,31.2226204699323,82.15850258861012,68.7773795300677,13.381123058542412,17.841497411389884
04200206,04,20,02,06,2912,792,2517,2120,397,395,100.0,27.197802197802197,86.43543956043956,72.8021978021978,13.633241758241757,13.564560439560438
04200207,04,20,02,07,3166,1202,2252,1964,288,914,100.0,37.9658875552748,71.13076437144662,62.03411244472521,9.096651926721416,28.86923562855338
04200308,04,20,03,08,6423,2421,4787,4002,785,1636,100.0,37.69266697804764,74.52903627588354,62.30733302195236,12.221703253931185,25.47096372411646
04200309,04,20,03,09,6939,1937,5885,5002,883,1054,100.0,27.914685113128694,84.8104914252774,72.08531488687132,12.72517653840611,15.189508574722582
04200310,04,20,03,10,7791,2890,6107,4901,1206,1684,100.0,37.09408291618534,78.38531639070723,62.90591708381466,15.479399306892569,21.614683609292772
04200311,04,20,03,11,7309,2882,5555,4427,1128,1754,100.0,39.430838692023535,76.00218908195376,60.56916130797647,15.433027773977287,23.997810918046245
04300412,04,30,04,12,3478,1892,2114,1586,528,1364,100.0,54.39907993099482,60.78205865439909,45.60092006900518,15.181138585393905,39.21794134560092
04300413,04,30,04,13,10225,4885,7563,5340,2223,2662,100.0,47.77506112469438,73.96577017114915,52.224938875305625,21.74083129584352,26.034229828850858
04300414,04,30,04,14,10695,4096,8328,6599,1729,2367,100.0,38.29827021972885,77.86816269284712,61.70172978027115,16.16643291257597,22.131837307152875
04300415,04,30,04,15,6389,2445,4941,3944,997,1448,100.0,38.268899671310066,77.33604632962906,61.731100328689934,15.604946000939112,22.66395367037095
04300416,04,30,04,16,11955,4879,8995,7076,1919,2960,100.0,40.81137599330824,75.2404851526558,59.18862400669176,16.051861145964033,24.759514847344207
04300517,04,30,05,17,9610,4471,6921,5139,1782,2689,100.0,46.52445369406868,72.01873048907387,53.47554630593132,18.54318418314256,27.981269510926122
04300518,04,30,05,18,5808,2704,4217,3104,1113,1591,100.0,46.5564738292011,72.60674931129476,53.4435261707989,19.163223140495866,27.393250688705233
04300619,04,30,06,19,8748,3963,6444,4785,1659,2304,100.0,45.30178326474623,73.66255144032921,54.698216735253766,18.964334705075444,26.337448559670783
04300620,04,30,06,20,3439,2027,2189,1412,777,1250,100.0,58.94155277697005,63.65222448386159,41.05844722302995,22.593777260831637,36.34777551613841
04300621,04,30,06,21,10659,5147,7672,5512,2160,2987,100.0,48.28783187916315,71.97673327704287,51.71216812083686,20.264565156206025,28.023266722957125
04300622,04,30,06,22,5215,3004,3479,2211,1268,1736,100.0,57.603068072866726,66.71140939597315,42.39693192713327,24.314477468839886,33.288590604026844
04300623,04,30,06,23,12054,6562,7812,5492,2320,4242,100.0,54.438360710137715,64.80836236933798,45.561639289862285,19.246723079475693,35.19163763066202
04300624,04,30,06,24,9384,4287,6636,5097,1539,2748,100.0,45.68414322250639,70.71611253196932,54.31585677749361,16.400255754475705,29.283887468030688
04400725,04,40,07,25,124,85,45,39,6,79,100.0,68.54838709677419,36.29032258064516,31.451612903225808,4.838709677419355,63.70967741935484
04400726,04,40,07,26,5440,2295,4162,3145,1017,1278,100.0,42.1875,76.50735294117646,57.8125,18.69485294117647,23.49264705882353
04400727,04,40,07,27,8250,3279,6456,4971,1485,1794,100.0,39.74545454545454,78.25454545454545,60.25454545454545,18.0,21.745454545454546
04400728,04,40,07,28,3132,1152,2512,1980,532,620,100.0,36.7816091954023,80.20434227330779,63.2183908045977,16.985951468710088,19.79565772669221
04400729,04,40,07,29,2850,1061,2283,1789,494,567,100.0,37.228070175438596,80.10526315789474,62.771929824561404,17.333333333333336,19.894736842105264
04400830,04,40,08,30,7080,2790,5601,4290,1311,1479,100.0,39.40677966101695,79.11016949152543,60.59322033898306,18.516949152542374,20.889830508474578
04400831,04,40,08,31,1495,407,1296,1088,208,199,100.0,27.224080267558527,86.68896321070234,72.77591973244148,13.91304347826087,13.31103678929766
04400832,04,40,08,32,6943,1811,5961,5132,829,982,100.0,26.08382543569062,85.85625810168514,73.91617456430937,11.940083537375774,14.143741898314849
04400833,04,40,08,33,4177,1521,3349,2656,693,828,100.0,36.41369403878382,80.17716064160881,63.58630596121618,16.590854680392628,19.82283935839119
04400834,04,40,08,34,3526,1131,2949,2395,554,577,100.0,32.07600680657969,83.63584798638684,67.9239931934203,15.711854792966534,16.364152013613158
04400835,04,40,08,35,10484,2961,8817,7523,1294,1667,100.0,28.24303700877528,84.0995803128577,71.75696299122473,12.342617321632964,15.900419687142312
04500936,04,50,09,36,5625,2523,4107,3102,1005,1518,100.0,44.85333333333333,73.01333333333334,55.14666666666667,17.866666666666667,26.986666666666665
04500937,04,50,09,37,7648,3223,5740,4425,1315,1908,100.0,42.14173640167364,75.05230125523012,57.85826359832637,17.194037656903767,24.947698744769873
04500938,04,50,09,38,7837,3546,5765,4291,1474,2072,100.0,45.24690570371315,73.56131172642593,54.75309429628684,18.808217430139084,26.438688273574073
04500939,04,50,09,39,6460,2973,4874,3487,1387,1586,100.0,46.021671826625386,75.44891640866874,53.978328173374614,21.470588235294116,24.55108359133127
04501040,04,50,10,40,5910,2572,4395,3338,1057,1515,100.0,43.51945854483926,74.36548223350253,56.48054145516075,17.884940778341793,25.63451776649746
04501041,04,50,10,41,5464,2491,3946,2973,973,1518,100.0,45.58931185944363,72.2181551976574,54.410688140556374,17.807467057101025,27.781844802342604
04501042,04,50,10,42,3588,2045,2222,1543,679,1366,100.0,56.99554069119287,61.92865105908584,43.004459308807135,18.92419175027871,38.071348940914156
04501043,04,50,10,43,11039,5029,8138,6010,2128,2901,100.0,45.55666274119032,73.72044569254462,54.44333725880968,19.27710843373494,26.27955430745538
04501044,04,50,10,44,5241,2206,3965,3035,930,1276,100.0,42.091203968708264,75.65350124022133,57.90879603129174,17.74470520892959,24.34649875977867
04501045,04,50,10,45,9135,4315,6462,4820,1642,2673,100.0,47.23590585659551,70.73891625615764,52.764094143404485,17.97482211275315,29.261083743842363
04501146,04,50,11,46,4701,2145,3382,2556,826,1319,100.0,45.628589661774086,71.9421399702191,54.371410338225914,17.570729631993192,28.057860029780894
04501147,04,50,11,47,5525,2397,4119,3128,991,1406,100.0,43.38461538461538,74.55203619909501,56.61538461538461,17.936651583710407,25.447963800904976
04501148,04,50,11,48,4420,1958,3313,2462,851,1107,100.0,44.29864253393665,74.95475113122171,55.70135746606335,19.253393665158374,25.04524886877828
04501149,04,50,11,49,9826,3945,7436,5881,1555,2390,100.0,40.14858538571138,75.67677590067169,59.85141461428862,15.825361286383066,24.323224099328314
04501150,04,50,11,50,3050,1156,2355,1894,461,695,100.0,37.90163934426229,77.21311475409836,62.09836065573771,15.114754098360656,22.78688524590164
04501151,04,50,11,51,7465,2461,6058,5004,1054,1407,100.0,32.967180174146016,81.15204286671131,67.03281982585398,14.119223040857335,18.84795713328868
04501152,04,50,11,52,6871,2977,5062,3894,1168,1809,100.0,43.327026633677775,73.67195459176247,56.672973366322225,16.998981225440257,26.32804540823752
04501153,04,50,11,53,7462,3357,5538,4105,1433,1924,100.0,44.98793889037792,74.21602787456446,55.01206110962209,19.203966764942372,25.78397212543554
05100101,05,10,01,01,4061,730,3742,3331,411,319,100.0,17.975868012804728,92.14479192317164,82.02413198719528,10.12065993597636,7.855208076828367
05100102,05,10,01,02,4330,1016,3744,3314,430,586,100.0,23.46420323325635,86.46651270207852,76.53579676674364,9.930715935334874,13.533487297921479
05100103,05,10,01,03,5908,2769,4227,3139,1088,1681,100.0,46.86865267433988,71.5470548408937,53.131347325660116,18.41570751523358,28.452945159106296
05100104,05,10,01,04,4812,1931,3891,2881,1010,921,100.0,40.12884455527847,80.86034912718205,59.87115544472152,20.989193682460517,19.139650872817953
05100105,05,10,01,05,7567,1521,6849,6046,803,718,100.0,20.10043610413638,90.51143121448393,79.89956389586362,10.611867318620325,9.488568785516057
05100206,05,10,02,06,3565,1576,2685,1989,696,880,100.0,44.20757363253857,75.31556802244039,55.79242636746143,19.52314165497896,24.684431977559605
05100207,05,10,02,07,2286,632,2040,1654,386,246,100.0,27.64654418197725,89.23884514435696,72.35345581802275,16.885389326334206,10.761154855643044
05100208,05,10,02,08,10663,4768,8007,5895,2112,2656,100.0,44.71537090874988,75.09143768170308,55.28462909125012,19.806808590452967,24.908562318296916
05100209,05,10,02,09,11687,6102,8854,5585,3269,2833,100.0,52.21185933088046,75.75939077607599,47.788140669119535,27.971250106956447,24.240609223924018
05100210,05,10,02,10,7681,2898,5888,4783,1105,1793,100.0,37.7294623095951,76.65668532743133,62.27053769040489,14.386147637026427,23.343314672568678
05100211,05,10,02,11,6112,2062,5094,4050,1044,1018,100.0,33.73691099476439,83.34424083769633,66.2630890052356,17.081151832460733,16.655759162303667
05100312,05,10,03,12,4019,1675,2952,2344,608,1067,100.0,41.67703408808161,73.45110724060712,58.32296591191839,15.128141328688729,26.548892759392885
05100313,05,10,03,13,6092,3272,4315,2820,1495,1777,100.0,53.70978332239002,70.83059750492448,46.29021667760998,24.54038082731451,29.16940249507551
05100314,05,10,03,14,7332,4331,4166,3001,1165,3166,100.0,59.06983087834151,56.81942171303873,40.93016912165848,15.88925259138025,43.180578286961264
05100315,05,10,03,15,6837,3114,4813,3723,1090,2024,100.0,45.54629223343572,70.39637267807518,54.453707766564285,15.942664911510896,29.60362732192482
05100316,05,10,03,16,10295,4239,7960,6056,1904,2335,100.0,41.175327829043226,77.31908693540554,58.824672170956774,18.49441476444876,22.680913064594463
05100317,05,10,03,17,3570,1703,2278,1867,411,1292,100.0,47.703081232493,63.8095238095238,52.29691876750701,11.512605042016807,36.19047619047619
05200418,05,20,04,18,3828,846,3571,2982,589,257,100.0,22.10031347962382,93.28631138975967,77.89968652037618,15.386624869383489,6.713688610240334
05200419,05,20,04,19,1686,101,1659,1585,74,27,100.0,5.9905100830367735,98.39857651245552,94.00948991696323,4.389086595492289,1.601423487544484
05200420,05,20,04,20,5792,1813,4957,3979,978,835,100.0,31.301795580110497,85.5835635359116,68.6982044198895,16.8853591160221,14.416436464088397
05200421,05,20,04,21,4370,1264,3608,3106,502,762,100.0,28.924485125858123,82.5629290617849,71.07551487414187,11.48741418764302,17.4370709382151
05200422,05,20,04,22,1091,224,989,867,122,102,100.0,20.531622364802935,90.65077910174152,79.46837763519706,11.182401466544455,9.349220898258478
05200423,05,20,04,23,6571,2211,5310,4360,950,1261,100.0,33.64784659869122,80.80961801856643,66.35215340130878,14.457464617257648,19.19038198143357
05200524,05,20,05,24,3338,964,2962,2374,588,376,100.0,28.879568603954464,88.73576992210904,71.12043139604553,17.61533852606351,11.264230077890952
05200525,05,20,05,25,2437,634,2223,1803,420,214,100.0,26.01559294214198,91.21871153057037,73.98440705785802,17.23430447271235,8.781288469429626
05200526,05,20,05,26,5647,3204,3434,2443,991,2213,100.0,56.73809102178148,60.81105011510537,43.26190897821852,17.549141136886842,39.18894988489463
05200527,05,20,05,27,11456,7087,7579,4369,3210,3877,100.0,61.86277932960894,66.15747206703911,38.13722067039106,28.020251396648042,33.84252793296089
05200528,05,20,05,28,6949,1841,6035,5108,927,914,100.0,26.493020578500502,86.84702834940279,73.5069794214995,13.340048927903295,13.152971650597209
05200629,05,20,06,29,7988,3208,6025,4780,1245,1963,100.0,40.16024036054081,75.42563845768653,59.83975963945919,15.585878818227341,24.57436154231347
05200630,05,20,06,30,9793,3651,7487,6142,1345,2306,100.0,37.2817318492801,76.45256816093128,62.7182681507199,13.734300010211376,23.54743183906872
05200631,05,20,06,31,8450,3243,6376,5207,1169,2074,100.0,38.37869822485207,75.45562130177514,61.62130177514793,13.83431952662722,24.544378698224854
05200632,05,20,06,32,3671,1697,2602,1974,628,1069,100.0,46.22718605284663,70.8798692454372,53.77281394715337,17.107055298283846,29.12013075456279
05200633,05,20,06,33,2015,546,1762,1469,293,253,100.0,27.09677419354839,87.44416873449131,72.90322580645162,14.540942928039701,12.555831265508685
05200634,05,20,06,34,4412,703,4073,3709,364,339,100.0,15.933816863100633,92.31640979147778,84.06618313689937,8.250226654578423,7.683590208522212
05300735,05,30,07,35,2049,1253,1644,796,848,405,100.0,61.15178135675939,80.23426061493412,38.84821864324061,41.38604197169351,19.765739385065885
05300736,05,30,07,36,3657,1940,2817,1717,1100,840,100.0,53.04894722450095,77.03035274815423,46.95105277549904,30.079299972655182,22.969647251845775
05300737,05,30,07,37,11349,5082,8846,6267,2579,2503,100.0,44.77927570711076,77.94519340911094,55.220724292889244,22.724469116221695,22.054806590889065
05300838,05,30,08,38,22,0,22,22,0,0,100.0,0.0,100.0,100.0,0.0,0.0
05300839,05,30,08,39,7595,3713,5399,3882,1517,2196,100.0,48.88742593811718,71.0862409479921,51.11257406188282,19.97366688610928,28.913759052007897
05300840,05,30,08,40,477,232,359,245,114,118,100.0,48.63731656184486,75.26205450733752,51.36268343815513,23.89937106918239,24.737945492662476
05300841,05,30,08,41,4588,2140,3356,2448,908,1232,100.0,46.64341761115955,73.14734088927636,53.35658238884046,19.79075850043592,26.852659110723625
05400942,05,40,09,42,3662,743,3342,2919,423,320,100.0,20.289459311851445,91.2616056799563,79.71054068814855,11.551064991807754,8.738394320043692
05400943,05,40,09,43,10412,1956,9779,8456,1323,633,100.0,18.786016135228582,93.92047637341528,81.21398386477142,12.706492508643871,6.0795236265847095
05400944,05,40,09,44,2216,382,2053,1834,219,163,100.0,17.23826714801444,92.64440433212997,82.76173285198556,9.882671480144404,7.355595667870037
05400945,05,40,09,45,3639,556,3425,3083,342,214,100.0,15.278922780983786,94.1192635339379,84.72107721901622,9.398186314921682,5.880736466062105
06100101,06,10,01,01,6881,1800,5973,5081,892,908,100.0,26.158988519110594,86.80424356924865,73.8410114808894,12.96323208835925,13.195756430751343
06100102,06,10,01,02,8744,3189,7059,5555,1504,1685,100.0,36.47072278133577,80.72964318389752,63.52927721866423,17.200365965233303,19.27035681610247
06100103,06,10,01,03,6212,1997,5204,4215,989,1008,100.0,32.147456535737284,83.7733419188667,67.85254346426271,15.920798454603993,16.22665808113329
06100204,06,10,02,04,6845,2459,5594,4386,1208,1251,100.0,35.92403214024836,81.72388604821037,64.07596785975164,17.64791818845873,18.276113951789625
06100205,06,10,02,05,9819,3264,8144,6555,1589,1675,100.0,33.24167430491903,82.94123637844994,66.75832569508097,16.182910683368977,17.058763621550057
06100206,06,10,02,06,7630,2293,6422,5337,1085,1208,100.0,30.052424639580604,84.16775884665793,69.9475753604194,14.220183486238533,15.832241153342071
06100207,06,10,02,07,7907,2669,6478,5238,1240,1429,100.0,33.75490072088023,81.92740609586441,66.24509927911977,15.682306816744656,18.072593904135577
06100208,06,10,02,08,6765,2090,5689,4675,1014,1076,100.0,30.89430894308943,84.09460458240946,69.10569105691057,14.988913525498893,15.90539541759054
06100209,06,10,02,09,9238,3310,7459,5928,1531,1779,100.0,35.83026629140507,80.74258497510284,64.16973370859493,16.5728512665079,19.257415024897163
06100210,06,10,02,10,4842,1448,4068,3394,674,774,100.0,29.904997934737708,84.01486988847584,70.09500206526229,13.919867823213547,15.985130111524162
06200311,06,20,03,11,4918,1173,4354,3745,609,564,100.0,23.851159007726718,88.53192354615697,76.14884099227328,12.383082553883693,11.468076453843025
06200312,06,20,03,12,6063,1936,4932,4127,805,1131,100.0,31.93138710209467,81.34586838198912,68.06861289790533,13.277255484083787,18.654131618010886
06200313,06,20,03,13,7373,2391,6111,4982,1129,1262,100.0,32.42913332429133,82.88349382883494,67.57086667570866,15.312627153126272,17.11650617116506
06200314,06,20,03,14,7262,2194,6146,5068,1078,1116,100.0,30.212062792619115,84.63233269071881,69.78793720738089,14.844395483337925,15.367667309281192
06200315,06,20,03,15,5766,1724,4902,4042,860,864,100.0,29.89941033645508,85.0156087408949,70.10058966354492,14.915019077349983,14.984391259105099
06200316,06,20,03,16,5374,2238,4186,3136,1050,1188,100.0,41.644957201339786,77.89356159285448,58.355042798660214,19.538518794194268,22.106438407145514
06200317,06,20,03,17,6373,1312,5781,5061,720,592,100.0,20.586850776714265,90.71081123489722,79.41314922328574,11.297662011611486,9.289188765102779
06200418,06,20,04,18,0,0,0,0,0,0,0.0,0.0,0.0,0.0,0.0,0.0
06200419,06,20,04,19,4623,2336,3411,2287,1124,1212,100.0,50.52995890114644,73.78325762491889,49.47004109885356,24.313216526065325,26.216742375081115
06200420,06,20,04,20,7113,2031,6028,5082,946,1085,100.0,28.553353015605232,84.7462392801912,71.44664698439477,13.299592295796428,15.2537607198088
06200421,06,20,04,21,8281,2181,7077,6100,977,1204,100.0,26.337398864871393,85.46069315300085,73.6626011351286,11.798092017872237,14.539306846999157
06200422,06,20,04,22,7075,1534,6168,5541,627,907,100.0,21.681978798586574,87.18021201413427,78.31802120141343,8.862190812720847,12.819787985865725
06200423,06,20,04,23,8572,2334,7449,6238,1211,1123,100.0,27.22818478768082,86.89920671955203,72.77181521231918,14.12739150723285,13.10079328044797
06300524,06,30,05,24,5658,1352,4845,4306,539,813,100.0,23.895369388476492,85.63096500530223,76.1046306115235,9.52633439377872,14.369034994697774
06300525,06,30,05,25,5555,1366,4798,4189,609,757,100.0,24.590459045904588,86.37263726372638,75.4095409540954,10.963096309630963,13.627362736273627
06300526,06,30,05,26,3299,1040,2731,2259,472,568,100.0,31.524704455895723,82.78266141254925,68.47529554410427,14.307365868444982,17.217338587450744
06300527,06,30,05,27,8377,2372,7193,6005,1188,1184,100.0,28.31562611913573,85.86606183597947,71.68437388086427,14.181687955115196,14.133938164020531
06300528,06,30,05,28,10981,2548,9781,8433,1348,1200,100.0,23.203715508605775,89.07203351243056,76.79628449139423,12.275749021036335,10.927966487569437
06300629,06,30,06,29,6992,1923,5970,5069,901,1022,100.0,27.502860411899317,85.38329519450801,72.4971395881007,12.886155606407323,14.61670480549199
06300630,06,30,06,30,5590,2175,4217,3415,802,1373,100.0,38.9087656529517,75.43828264758497,61.09123434704829,14.347048300536672,24.561717352415027
06300631,06,30,06,31,2921,1002,2249,1919,330,672,100.0,34.3033207805546,76.99418007531668,65.6966792194454,11.297500855871277,23.005819924683326
06300632,06,30,06,32,13532,3835,11813,9697,2116,1719,100.0,28.340230564587642,87.29677800768549,71.65976943541236,15.637008572273132,12.703221992314514
06300633,06,30,06,33,11970,3051,10336,8919,1417,1634,100.0,25.48872180451128,86.34920634920636,74.51127819548871,11.837928153717629,13.65079365079365
06300634,06,30,06,34,8428,1989,7400,6439,961,1028,100.0,23.599905078310393,87.80256288561937,76.40009492168961,11.402467963929757,12.197437114380635
06400735,06,40,07,35,10134,2288,8856,7846,1010,1278,100.0,22.57746200907835,87.38898756660745,77.42253799092165,9.96644957568581,12.61101243339254
06400736,06,40,07,36,5245,1089,4789,4156,633,456,100.0,20.762631077216394,91.30600571973308,79.2373689227836,12.068636796949475,8.69399428026692
06400737,06,40,07,37,11375,3481,8941,7894,1047,2434,100.0,30.6021978021978,78.60219780219781,69.39780219780219,9.204395604395604,21.3978021978022
06400838,06,40,08,38,7394,1348,6746,6046,700,648,100.0,18.230998106572898,91.23613740870977,81.7690018934271,9.467135515282662,8.763862591290234
06400839,06,40,08,39,5252,1171,4682,4081,601,570,100.0,22.296268088347297,89.14699162223914,77.70373191165271,11.443259710586444,10.853008377760853
06400840,06,40,08,40,7210,1178,6632,6032,600,578,100.0,16.338418862690705,91.98335644937586,83.6615811373093,8.321775312066574,8.016643550624133
06400841,06,40,08,41,5927,1482,5205,4445,760,722,100.0,25.00421798549013,87.81845790450481,74.99578201450987,12.822675889994938,12.181542095495193
06400842,06,40,08,42,4784,1769,4088,3015,1073,696,100.0,36.97742474916388,85.45150501672241,63.02257525083612,22.428929765886288,14.54849498327759
06400843,06,40,08,43,4808,1445,3964,3363,601,844,100.0,30.054076539101498,82.44592346089851,69.94592346089851,12.5,17.554076539101498
06400844,06,40,08,44,7159,2298,5956,4861,1095,1203,100.0,32.09945523117754,83.1959770917726,67.90054476882246,15.295432322950134,16.804022908227406
07100101,07,10,01,01,9797,4713,7055,5084,1971,2742,100.0,48.10656323364295,72.01184035929367,51.89343676635705,20.118403592936613,27.98815964070634
07100102,07,10,01,02,8595,4343,5752,4252,1500,2843,100.0,50.52937754508435,66.92262943571843,49.47062245491565,17.452006980802793,33.07737056428156
07100103,07,10,01,03,7752,4898,4937,2854,2083,2815,100.0,63.18369453044376,63.68679050567595,36.81630546955624,26.870485036119714,36.31320949432404
07100204,07,10,02,04,10439,4140,7974,6299,1675,2465,100.0,39.65897116582048,76.38662707155858,60.341028834179525,16.04559823737906,23.61337292844142
07100205,07,10,02,05,5206,3515,3228,1691,1537,1978,100.0,67.51824817518248,62.00537840952747,32.481751824817515,29.52362658470995,37.99462159047253
07100206,07,10,02,06,8253,4048,5832,4205,1627,2421,100.0,49.04883072822004,70.66521264994547,50.95116927177996,19.714043378165517,29.334787350054526
07200307,07,20,03,07,10582,3846,8499,6736,1763,2083,100.0,36.34473634473635,80.31563031563032,63.65526365526365,16.66036666036666,19.684369684369685
07200308,07,20,03,08,10481,4777,7601,5704,1897,2880,100.0,45.577712050376874,72.5217059440893,54.422287949623126,18.099417994466176,27.478294055910695
07200409,07,20,04,09,9373,3563,7333,5810,1523,2040,100.0,38.0134428678118,78.23535687613358,61.9865571321882,16.248799743945376,21.764643123866424
07200410,07,20,04,10,5551,3012,3859,2539,1320,1692,100.0,54.2604936047559,69.51900558457935,45.7395063952441,23.779499189335255,30.480994415420643
07200411,07,20,04,11,2751,1219,2044,1532,512,707,100.0,44.31115957833515,74.30025445292621,55.68884042166486,18.611414031261358,25.699745547073793
07200412,07,20,04,12,1500,894,912,606,306,588,100.0,59.599999999999994,60.8,40.400000000000006,20.4,39.2
07200413,07,20,04,13,7847,2760,6245,5087,1158,1602,100.0,35.172677456352744,79.58455460685613,64.82732254364726,14.75723206320887,20.415445393143877
07200414,07,20,04,14,3721,1457,2924,2264,660,797,100.0,39.15614082235958,78.58102660575115,60.843859177640425,17.737167428110723,21.41897339424886
07300515,07,30,05,15,6852,1746,6021,5106,915,831,100.0,25.481611208406306,87.87215411558668,74.5183887915937,13.353765323992995,12.12784588441331
07300516,07,30,05,16,8806,2565,7401,6241,1160,1405,100.0,29.12786736316148,84.04496933908699,70.87213263683851,13.172836702248466,15.955030660913014
07300517,07,30,05,17,8755,2594,7305,6161,1144,1450,100.0,29.628783552255854,83.4380354083381,70.37121644774415,13.066818960593945,16.56196459166191
07300618,07,30,06,18,9355,3004,7769,6351,1418,1586,100.0,32.11117049706039,83.04649919828968,67.8888295029396,15.157669695350078,16.953500801710316
07300619,07,30,06,19,12293,5514,9441,6779,2662,2852,100.0,44.8547954120231,76.79980476694054,55.14520458797689,21.654600178963637,23.200195233059464
07400720,07,40,07,20,11960,4920,9587,7040,2547,2373,100.0,41.1371237458194,80.15886287625418,58.862876254180605,21.295986622073578,19.84113712374582
07400721,07,40,07,21,5394,1723,4626,3671,955,768,100.0,31.94289951798294,85.76195773081201,68.05710048201705,17.70485724879496,14.238042269187986
07400822,07,40,08,22,2229,482,2012,1747,265,217,100.0,21.62404665769403,90.26469268730372,78.37595334230598,11.888739344997756,9.735307312696277
07400823,07,40,08,23,9745,3555,7894,6190,1704,1851,100.0,36.48024628014366,81.00564391995896,63.51975371985633,17.485890200102617,18.994356080041047
07400824,07,40,08,24,7343,2960,5664,4383,1281,1679,100.0,40.31049979572382,77.13468609560125,59.68950020427618,17.44518589132507,22.865313904398747
07400825,07,40,08,25,7335,3109,5588,4226,1362,1747,100.0,42.38582140422631,76.1826857532379,57.614178595773694,18.56850715746421,23.817314246762102
07400826,07,40,08,26,5087,1415,4403,3672,731,684,100.0,27.81600157263613,86.55396107725575,72.18399842736387,14.369962649891882,13.446038922744249
07400927,07,40,09,27,11065,5037,8183,6028,2155,2882,100.0,45.521915951197464,73.95390872119295,54.478084048802536,19.47582467239042,26.046091278807047
07400928,07,40,09,28,3928,2244,2518,1684,834,1410,100.0,57.128309572301426,64.10386965376782,42.871690427698574,21.23217922606925,35.896130346232184
07501029,07,50,10,29,8134,3417,6380,4717,1663,1754,100.0,42.00885173346447,78.43619375461027,57.99114826653553,20.445045488074747,21.56380624538972
07501030,07,50,10,30,8831,3776,6845,5055,1790,1986,100.0,42.75846450005662,77.51104065224777,57.24153549994339,20.269505152304383,22.488959347752235
07501031,07,50,10,31,8957,3032,7505,5925,1580,1452,100.0,33.85061962710729,83.78921513899743,66.14938037289271,17.639834766104723,16.210784861002566
07501032,07,50,10,32,5616,1909,4737,3707,1030,879,100.0,33.99216524216524,84.3482905982906,66.00783475783476,18.340455840455842,15.651709401709402
07501133,07,50,11,33,8097,3239,6217,4858,1359,1880,100.0,40.002470050636035,76.78152402124243,59.99752994936396,16.783994071878475,23.218475978757564
07501134,07,50,11,34,10540,3154,9058,7386,1672,1482,100.0,29.924098671726757,85.9392789373814,70.07590132827325,15.86337760910816,14.060721062618594
07501135,07,50,11,35,2223,527,1990,1696,294,233,100.0,23.706702654071073,89.51866846603689,76.29329734592892,13.225371120107962,10.481331533963113
07601236,07,60,12,36,10150,4349,7757,5801,1956,2393,100.0,42.847290640394085,76.42364532019704,57.152709359605915,19.27093596059113,23.576354679802954
07601237,07,60,12,37,4767,1239,4206,3528,678,561,100.0,25.991189427312776,88.23159219634991,74.00881057268722,14.22278162366268,11.768407803650094
07601238,07,60,12,38,2856,1143,2324,1713,611,532,100.0,40.02100840336135,81.37254901960785,59.97899159663865,21.393557422969188,18.627450980392158
07601339,07,60,13,39,5716,2342,4813,3374,1439,903,100.0,40.97270818754374,84.20223932820154,59.02729181245626,25.174947515745277,15.79776067179846
07601340,07,60,13,40,6406,2747,5283,3659,1624,1123,100.0,42.88167343115829,82.46955978769903,57.11832656884172,25.35123321885732,17.530440212300967
07601341,07,60,13,41,2249,676,1892,1573,319,357,100.0,30.057803468208093,84.12627834593152,69.94219653179191,14.184081814139619,15.873721654068476
07601442,07,60,14,42,10457,2429,9323,8028,1295,1134,100.0,23.22845940518313,89.15558955723439,76.77154059481687,12.38404896241752,10.844410442765613
07601443,07,60,14,43,10915,2548,9895,8367,1528,1020,100.0,23.344021988089786,90.65506184150252,76.65597801191022,13.999083829592305,9.34493815849748
07601544,07,60,15,44,8661,2685,7359,5976,1383,1302,100.0,31.001039140976793,84.96709386906824,68.9989608590232,15.96813301004503,15.032906130931764
07601545,07,60,15,45,8367,3392,6415,4975,1440,1952,100.0,40.540217521214295,76.670252181188,59.459782478785705,17.210469702402296,23.329747818812
07601546,07,60,15,46,6965,1405,6346,5560,786,619,100.0,20.172290021536252,91.11270638908829,79.82770997846374,11.28499641062455,8.887293610911701
07601547,07,60,15,47,3850,818,3368,3032,336,482,100.0,21.246753246753247,87.48051948051948,78.75324675324676,8.727272727272728,12.519480519480519
07601548,07,60,15,48,2942,557,2679,2385,294,263,100.0,18.93269884432359,91.06050305914344,81.0673011556764,9.993201903467028,8.93949694085656
08100101,08,10,01,01,4643,2627,2860,2016,844,1783,100.0,56.57979754469093,61.598104673702345,43.42020245530907,18.177902218393278,38.401895326297655
08100102,08,10,01,02,8179,4316,5303,3863,1440,2876,100.0,52.769287198924076,64.8367771121164,47.230712801075924,17.60606431104047,35.163222887883606
08100103,08,10,01,03,7370,3677,4976,3693,1283,2394,100.0,49.89145183175034,67.516960651289,50.108548168249655,17.40841248303935,32.48303934871099
08100104,08,10,01,04,6653,3813,4270,2840,1430,2383,100.0,57.31249060574177,64.18157222305727,42.68750939425823,21.494062828799038,35.818427776942734
08100105,08,10,01,05,5659,3646,3494,2013,1481,2165,100.0,64.4283442304294,61.7423573069447,35.5716557695706,26.170701537374097,38.25764269305531
08100206,08,10,02,06,9575,5567,5964,4008,1956,3611,100.0,58.14099216710182,62.28720626631854,41.85900783289817,20.428198433420366,37.71279373368146
08100207,08,10,02,07,7460,4983,4926,2477,2449,2534,100.0,66.79624664879357,66.03217158176943,33.20375335120643,32.828418230563,33.96782841823056
08100208,08,10,02,08,12275,6824,7924,5451,2473,4351,100.0,55.59266802443992,64.55397148676171,44.40733197556008,20.14663951120163,35.44602851323829
08100209,08,10,02,09,8458,5044,5060,3414,1646,3398,100.0,59.63584771813668,59.825017734689055,40.364152281863326,19.460865452825725,40.17498226531095
08100310,08,10,03,10,7805,3944,5402,3861,1541,2403,100.0,50.53171044202435,69.21204356181934,49.46828955797566,19.743754003843687,30.787956438180654
08100311,08,10,03,11,7313,3475,5056,3838,1218,2257,100.0,47.51811841925338,69.13715301517846,52.48188158074662,16.655271434431835,30.86284698482155
08100312,08,10,03,12,11863,6113,7885,5750,2135,3978,100.0,51.52996712467336,66.4671668212088,48.470032875326645,17.997133945882155,33.5328331787912
08100313,08,10,03,13,3858,1460,3015,2398,617,843,100.0,37.84344219803007,78.14930015552099,62.15655780196994,15.992742353551062,21.850699844479003
08100314,08,10,03,14,8118,4953,4853,3165,1688,3265,100.0,61.01256467110125,59.78073417097808,38.98743532889875,20.79329884207933,40.21926582902193
08100415,08,10,04,15,6475,3398,4316,3077,1239,2159,100.0,52.47876447876448,66.65637065637065,47.521235521235525,19.135135135135133,33.343629343629345
08100416,08,10,04,16,6517,3404,4378,3113,1265,2139,100.0,52.232622372257175,67.17814945527083,47.767377627742825,19.410771827528002,32.82185054472917
08100417,08,10,04,17,9807,5334,6333,4473,1860,3474,100.0,54.389721627408996,64.57632303456715,45.610278372591004,18.966044661976138,35.423676965432854
08100418,08,10,04,18,9537,4526,6642,5011,1631,2895,100.0,47.457271678724965,69.64454230890217,52.542728321275035,17.10181398762714,30.355457691097833
08100419,08,10,04,19,7079,4323,4181,2756,1425,2898,100.0,61.06794745020483,59.062014408814804,38.93205254979517,20.129961859019634,40.937985591185196
08100520,08,10,05,20,5780,4287,3660,1493,2167,2120,100.0,74.16955017301038,63.32179930795848,25.83044982698962,37.491349480968864,36.67820069204152
08100521,08,10,05,21,9580,6318,6723,3262,3461,2857,100.0,65.94989561586638,70.17745302713988,34.05010438413361,36.127348643006265,29.822546972860124
08200622,08,20,06,22,5610,3833,3124,1777,1347,2486,100.0,68.32442067736186,55.68627450980392,31.675579322638146,24.010695187165776,44.31372549019608
08200623,08,20,06,23,6051,2788,4513,3263,1250,1538,100.0,46.07502892083953,74.58271360105768,53.924971079160464,20.65774252189721,25.417286398942323
08200624,08,20,06,24,8732,4112,6652,4620,2032,2080,100.0,47.09115895556574,76.17956939990839,52.90884104443426,23.27072835547412,23.820430600091616
08200725,08,20,07,25,2464,784,2174,1680,494,290,100.0,31.818181818181817,88.23051948051948,68.18181818181817,20.0487012987013,11.76948051948052
08200726,08,20,07,26,6226,1816,5396,4410,986,830,100.0,29.168005139736586,86.66880822357854,70.83199486026342,15.83681336331513,13.33119177642146
08200727,08,20,07,27,7962,2402,6853,5560,1293,1109,100.0,30.16829942225571,86.07133885958302,69.83170057774429,16.239638281838733,13.928661140416981
08200728,08,20,07,28,1226,391,1056,835,221,170,100.0,31.89233278955954,86.13376835236541,68.10766721044045,18.02610114192496,13.866231647634583
08200729,08,20,07,29,1841,669,1586,1172,414,255,100.0,36.33894622487778,86.14883215643671,63.66105377512221,22.487778381314502,13.85116784356328
08200730,08,20,07,30,3382,1137,2790,2245,545,592,100.0,33.61916026020106,82.49556475458309,66.38083973979893,16.114725014784153,17.504435245416914
08200831,08,20,08,31,8335,2381,7300,5954,1346,1035,100.0,28.56628674265147,87.58248350329933,71.43371325734853,16.14877024595081,12.41751649670066
08200832,08,20,08,32,11529,3662,9972,7867,2105,1557,100.0,31.76337930436291,86.49492583918813,68.23662069563709,18.258305143551045,13.505074160811867
08200833,08,20,08,33,8658,4057,6598,4601,1997,2060,100.0,46.85839685839686,76.20697620697621,53.14160314160314,23.065373065373066,23.793023793023792
08300934,08,30,09,34,12518,6615,9789,5903,3886,2729,100.0,52.84390477712094,78.19939287426106,47.15609522287905,31.043297651382012,21.800607125738935
08300935,08,30,09,35,7329,3244,6012,4085,1927,1317,100.0,44.26251876108609,82.03029062627917,55.7374812389139,26.292809387365264,17.969709373720836
08301036,08,30,10,36,7176,3476,5684,3700,1984,1492,100.0,48.439241917502784,79.20847268673356,51.560758082497216,27.647714604236345,20.791527313266446
08301037,08,30,10,37,10577,6135,8069,4442,3627,2508,100.0,58.003214522076206,76.28817244965491,41.9967854779238,34.291386971731114,23.711827550345088
08401138,08,40,11,38,2880,974,2481,1906,575,399,100.0,33.81944444444444,86.14583333333333,66.18055555555556,19.96527777777778,13.854166666666668
08401139,08,40,11,39,4121,1422,3513,2699,814,608,100.0,34.50618781849066,85.24629944188304,65.49381218150934,19.752487260373698,14.753700558116961
08401140,08,40,11,40,2664,938,2249,1726,523,415,100.0,35.21021021021021,84.42192192192192,64.7897897897898,19.63213213213213,15.578078078078079
08401241,08,40,12,41,8181,2950,6932,5231,1701,1249,100.0,36.05916147170273,84.73291773621806,63.94083852829727,20.792079207920793,15.267082263781933
08401242,08,40,12,42,6819,1768,6098,5051,1047,721,100.0,25.92755536002346,89.4266021410764,74.07244463997654,15.354157501099868,10.573397858923595
08401243,08,40,12,43,9982,3008,8567,6974,1593,1415,100.0,30.1342416349429,85.82448407132838,69.8657583650571,15.958725706271288,14.175515928671608
08401244,08,40,12,44,7133,1792,6554,5341,1213,579,100.0,25.122669283611383,91.88279826160101,74.87733071638861,17.005467545212394,8.117201738398991
08401245,08,40,12,45,3744,1160,3319,2584,735,425,100.0,30.982905982905983,88.64850427350427,69.01709401709401,19.631410256410255,11.351495726495726
08401246,08,40,12,46,7929,2167,7029,5762,1267,900,100.0,27.330054231302814,88.64926220204313,72.66994576869719,15.979316433345945,11.350737797956867
09100101,09,10,01,01,13153,4334,10586,8819,1767,2567,100.0,32.950657644643805,80.48353987683419,67.04934235535619,13.434197521477989,19.516460123165817
09100202,09,10,02,02,4334,852,3865,3482,383,469,100.0,19.65851407475773,89.17858790955238,80.34148592524227,8.837101984310106,10.821412090447623
09100203,09,10,02,03,6895,1342,5985,5553,432,910,100.0,19.463379260333575,86.80203045685279,80.53662073966642,6.265409717186367,13.19796954314721
09100304,09,10,03,04,11702,2051,10424,9651,773,1278,100.0,17.52691847547428,89.07878995043582,82.47308152452572,6.605708425910101,10.921210049564177
09100305,09,10,03,05,4030,801,3531,3229,302,499,100.0,19.87593052109181,87.61786600496278,80.12406947890818,7.49379652605459,12.382133995037222
09100306,09,10,03,06,3047,922,2538,2125,413,509,100.0,30.259271414506074,83.29504430587463,69.74072858549393,13.554315720380702,16.70495569412537
09100407,09,10,04,07,8426,1061,7775,7365,410,651,100.0,12.591977213387134,92.27391407548066,87.40802278661286,4.86589128886779,7.726085924519345
09100408,09,10,04,08,8168,1334,7370,6834,536,798,100.0,16.332027424094026,90.23016650342801,83.66797257590598,6.562193927522038,9.769833496571987
09100409,09,10,04,09,3572,771,3262,2801,461,310,100.0,21.58454647256439,91.32138857782755,78.4154535274356,12.905935050391937,8.678611422172452
09200510,09,20,05,10,7577,2546,5642,5031,611,1935,100.0,33.60168932295103,74.46218820113502,66.39831067704897,8.063877524086049,25.537811798864986
09200511,09,20,05,11,12604,3011,10536,9593,943,2068,100.0,23.889241510631546,83.59251031418597,76.11075848936846,7.481751824817519,16.407489685814028
09200512,09,20,05,12,3579,987,2876,2592,284,703,100.0,27.577535624476113,80.3576417993853,72.42246437552389,7.935177423861414,19.642358200614694
09200613,09,20,06,13,9613,3065,7224,6548,676,2389,100.0,31.88390720898783,75.14823676271716,68.11609279101218,7.032143971704982,24.851763237282846
09200614,09,20,06,14,3561,331,3349,3230,119,212,100.0,9.295141814097164,94.04661611906768,90.70485818590284,3.3417579331648413,5.953383880932322
09200715,09,20,07,15,3100,1327,2111,1773,338,989,100.0,42.806451612903224,68.09677419354838,57.19354838709677,10.903225806451614,31.903225806451612
09200716,09,20,07,16,7592,1658,6354,5934,420,1238,100.0,21.83877766069547,83.69336143308746,78.16122233930453,5.532139093782929,16.30663856691254
09200717,09,20,07,17,9535,1839,8208,7696,512,1327,100.0,19.286837965390667,86.08285264813844,80.71316203460933,5.369690613529103,13.917147351861564
09200818,09,20,08,18,3187,400,2918,2787,131,269,100.0,12.550988390335737,91.55946030749922,87.44901160966427,4.110448697834954,8.440539692500785
09200819,09,20,08,19,8347,1917,6957,6430,527,1390,100.0,22.96633521025518,83.34731041092608,77.03366478974482,6.313645621181263,16.65268958907392
09300920,09,30,09,20,12163,2227,11039,9936,1103,1124,100.0,18.30962755899038,90.7588588341692,81.69037244100961,9.068486393159581,9.241141165830797
09300921,09,30,09,21,2721,357,2544,2364,180,177,100.0,13.120176405733186,93.49503858875413,86.87982359426681,6.615214994487322,6.504961411245866
09300922,09,30,09,22,5761,1121,5036,4640,396,725,100.0,19.458427356361742,87.41537927443153,80.54157264363826,6.873806630793265,12.584620725568477
09300923,09,30,09,23,8014,1603,7313,6411,902,701,100.0,20.002495632642876,91.25280758672324,79.99750436735712,11.25530321936611,8.747192413276766
09301024,09,30,10,24,2495,291,2359,2204,155,136,100.0,11.663326653306614,94.54909819639279,88.33667334669339,6.212424849699398,5.4509018036072145
09301025,09,30,10,25,10898,1657,9810,9241,569,1088,100.0,15.204624701780142,90.01651679207194,84.79537529821985,5.221141493852083,9.98348320792806
09301126,09,30,11,26,7343,1157,6609,6186,423,734,100.0,15.75650279177448,90.00408552362794,84.24349720822552,5.760588315402424,9.995914476372054
09301227,09,30,12,27,1877,175,1808,1702,106,69,100.0,9.323388385721897,96.3239211507725,90.6766116142781,5.647309536494406,3.6760788492274905
09301228,09,30,12,28,2627,281,2474,2346,128,153,100.0,10.69661210506281,94.17586600685193,89.30338789493719,4.872478111914732,5.824133993148077
09401329,09,40,13,29,10128,677,9732,9451,281,396,100.0,6.6844391785150075,96.09004739336493,93.315560821485,2.7744865718799367,3.909952606635071
09401330,09,40,13,30,1900,198,1802,1702,100,98,100.0,10.421052631578947,94.84210526315789,89.57894736842105,5.263157894736842,5.157894736842105
09401431,09,40,14,31,5396,467,5153,4929,224,243,100.0,8.654558932542624,95.49666419570052,91.34544106745737,4.151223128243143,4.503335804299481
09401432,09,40,14,32,1570,253,1416,1317,99,154,100.0,16.11464968152866,90.19108280254777,83.88535031847134,6.305732484076433,9.80891719745223
09401433,09,40,14,33,4334,562,3931,3772,159,403,100.0,12.967235809875405,90.7014305491463,87.0327641901246,3.6686663590216892,9.298569450853716
09401534,09,40,15,34,7340,1521,6323,5819,504,1017,100.0,20.722070844686648,86.14441416893733,79.27792915531336,6.866485013623978,13.855585831062669
09401635,09,40,16,35,6851,574,6599,6277,322,252,100.0,8.37833892862356,96.3217048606043,91.62166107137644,4.70004378922785,3.678295139395708
09501736,09,50,17,36,4597,495,4272,4102,170,325,100.0,10.76789210354579,92.9301718512073,89.23210789645421,3.6980639547530996,7.069828148792691
09501737,09,50,17,37,14440,1203,13786,13237,549,654,100.0,8.331024930747922,95.47091412742382,91.66897506925208,3.801939058171745,4.529085872576177
09501838,09,50,18,38,9937,994,9393,8943,450,544,100.0,10.003019019824896,94.52551071752038,89.9969809801751,4.528529737345275,5.474489282479621
09501939,09,50,19,39,6402,1085,5669,5317,352,733,100.0,16.947828803498908,88.55045298344267,83.05217119650109,5.498281786941581,11.449547016557325
09501940,09,50,19,40,2684,440,2379,2244,135,305,100.0,16.39344262295082,88.63636363636364,83.60655737704919,5.029806259314456,11.363636363636363
09501941,09,50,19,41,2762,354,2529,2408,121,233,100.0,12.816799420709632,91.56408399710355,87.18320057929037,4.3808834178131795,8.435916002896452
09502042,09,50,20,42,4150,439,3862,3711,151,288,100.0,10.578313253012048,93.06024096385542,89.42168674698794,3.63855421686747,6.9397590361445785
09502043,09,50,20,43,9132,783,8670,8349,321,462,100.0,8.5742444152431,94.94086727989487,91.4257555847569,3.515111695137976,5.059132720105125
10100101,10,10,01,01,5666,1616,4720,4050,670,946,100.0,28.521002470878926,83.30391810801271,71.47899752912107,11.824920578891634,16.696081891987294
10100102,10,10,01,02,3400,990,2713,2410,303,687,100.0,29.117647058823533,79.79411764705883,70.88235294117648,8.911764705882351,20.205882352941178
10100103,10,10,01,03,7647,2009,6535,5638,897,1112,100.0,26.2717405518504,85.45834967961292,73.7282594481496,11.730090231463318,14.541650320387081
10100104,10,10,01,04,7606,2211,6621,5395,1226,985,100.0,29.069155929529316,87.04969760715224,70.93084407047068,16.11885353668157,12.950302392847751
10100205,10,10,02,05,1203,790,466,413,53,737,100.0,65.66916043225271,38.73649210307564,34.330839567747304,4.405652535328346,61.26350789692435
10100206,10,10,02,06,10956,2890,9382,8066,1316,1574,100.0,26.37824023366192,85.63344286235852,73.62175976633807,12.011683096020445,14.366557137641475
10100207,10,10,02,07,8220,1438,7339,6782,557,881,100.0,17.49391727493917,89.28223844282238,82.50608272506082,6.776155717761558,10.717761557177615
10100208,10,10,02,08,9283,2355,7919,6928,991,1364,100.0,25.368954001939027,85.30647420015082,74.63104599806097,10.675428202089842,14.693525799849185
10100209,10,10,02,09,8067,2096,6770,5971,799,1297,100.0,25.98239742159415,83.92215197719104,74.01760257840586,9.904549398785175,16.077848022808976
10100210,10,10,02,10,10704,2808,9249,7896,1353,1455,100.0,26.23318385650224,86.40695067264575,73.76681614349776,12.64013452914798,13.59304932735426
10100311,10,10,03,11,2228,635,1842,1593,249,386,100.0,28.50089766606822,82.6750448833034,71.49910233393177,11.175942549371634,17.32495511669659
10100312,10,10,03,12,15039,4069,12851,10970,1881,2188,100.0,27.056320234058116,85.45116031651041,72.94367976594188,12.507480550568523,14.548839683489595
10100313,10,10,03,13,4729,1414,3841,3315,526,888,100.0,29.900613237470925,81.22224571791077,70.09938676252908,11.122858955381687,18.777754282089237
10100314,10,10,03,14,6318,1227,5682,5091,591,636,100.0,19.420702754036085,89.9335232668566,80.57929724596391,9.354226020892687,10.0664767331434
10100315,10,10,03,15,7132,1859,6237,5273,964,895,100.0,26.06561974200785,87.45092540661807,73.93438025799215,13.51654514862591,12.54907459338194
10100316,10,10,03,16,3726,544,3510,3182,328,216,100.0,14.600107353730543,94.20289855072464,85.39989264626946,8.80300590445518,5.797101449275362
10200417,10,20,04,17,7185,2436,5774,4749,1025,1411,100.0,33.90396659707724,80.36186499652052,66.09603340292276,14.265831593597772,19.63813500347947
10200418,10,20,04,18,5418,710,4994,4708,286,424,100.0,13.104466592838687,92.17423403469915,86.89553340716132,5.278700627537837,7.825765965300849
10200419,10,20,04,19,3558,1460,2537,2098,439,1021,100.0,41.034288926363125,71.30410342889265,58.965711073636875,12.338392355255762,28.695896571107365
10200420,10,20,04,20,7188,1931,5685,5257,428,1503,100.0,26.86421814134669,79.09015025041735,73.13578185865332,5.954368391764051,20.909849749582637
10200421,10,20,04,21,1741,895,1212,846,366,529,100.0,51.40723721998851,69.61516369902355,48.59276278001149,21.022400919012064,30.38483630097645
10200422,10,20,04,22,6548,2544,4490,4004,486,2058,100.0,38.85155772755039,68.57055589492975,61.1484422724496,7.422113622480146,31.429444105070246
10200423,10,20,04,23,5888,1860,4590,4028,562,1298,100.0,31.589673913043477,77.95516304347827,68.41032608695652,9.544836956521738,22.04483695652174
10200524,10,20,05,24,10436,2283,8830,8153,677,1606,100.0,21.876197776926027,84.61096205442699,78.12380222307398,6.48715983135301,15.389037945573017
10200525,10,20,05,25,5306,1388,4303,3918,385,1003,100.0,26.159065209197134,81.0968714662646,73.84093479080288,7.255936675461741,18.903128533735394
10200526,10,20,05,26,6071,2090,4569,3981,588,1502,100.0,34.42595947949267,75.25943007741724,65.57404052050732,9.6853895569099,24.740569922582768
10200627,10,20,06,27,3450,742,3010,2708,302,440,100.0,21.507246376811594,87.2463768115942,78.4927536231884,8.753623188405797,12.753623188405797
10200628,10,20,06,28,6438,1640,5332,4798,534,1106,100.0,25.473749611680645,82.82075178626903,74.52625038831935,8.294501397949674,17.179248213730972
10200629,10,20,06,29,8987,1529,8111,7458,653,876,100.0,17.01346389228886,90.25258707021253,82.98653610771115,7.266050962501391,9.74741292978747
10200630,10,20,06,30,6476,883,6027,5593,434,449,100.0,13.634959851760344,93.06670784434836,86.36504014823966,6.70166769610871,6.933292155651636
10300731,10,30,07,31,7653,1224,6894,6429,465,759,100.0,15.9937279498236,90.08232065856528,84.0062720501764,6.0760486083888665,9.917679341434733
10300732,10,30,07,32,6923,1529,6062,5394,668,861,100.0,22.085800953343927,87.56319514661274,77.91419904665608,9.648996099956667,12.43680485338726
10300733,10,30,07,33,4229,844,3775,3385,390,454,100.0,19.957436746275715,89.26460156065264,80.04256325372428,9.22203830692835,10.735398439347362
10300734,10,30,07,34,10323,1239,9778,9084,694,545,100.0,12.002324905550713,94.7205269785915,87.99767509444929,6.722851884142207,5.2794730214085055
10400835,10,40,08,35,7812,711,7449,7101,348,363,100.0,9.101382488479262,95.35330261136713,90.89861751152074,4.45468509984639,4.646697388632873
10400836,10,40,08,36,3858,418,3585,3440,145,273,100.0,10.834629341627787,92.92379471228615,89.16537065837221,3.7584240539139455,7.076205287713841
10400837,10,40,08,37,7736,516,7550,7220,330,186,100.0,6.670113753877974,97.59565667011375,93.32988624612203,4.265770423991727,2.404343329886246
10400938,10,40,09,38,9938,807,9611,9131,480,327,100.0,8.120346146105856,96.70959951700543,91.87965385389414,4.829945663111291,3.290400482994566
10400939,10,40,09,39,4438,506,4165,3932,233,273,100.0,11.401532221721496,93.84858044164038,88.5984677782785,5.250112663361875,6.151419558359621
10400940,10,40,09,40,5727,371,5548,5356,192,179,100.0,6.478086258075781,96.87445433909552,93.52191374192422,3.352540597171294,3.125545660904488
10400941,10,40,09,41,9680,786,9364,8894,470,316,100.0,8.119834710743802,96.73553719008264,91.8801652892562,4.855371900826446,3.2644628099173554
11100101,11,10,01,01,3260,258,3125,3002,123,135,100.0,7.914110429447853,95.85889570552148,92.08588957055215,3.7730061349693247,4.141104294478527
11100102,11,10,01,02,2087,564,1671,1523,148,416,100.0,27.02443699089602,80.067081935793,72.97556300910398,7.0915189266890275,19.932918064206994
11100203,11,10,02,03,8939,2997,7018,5942,1076,1921,100.0,33.527240183465715,78.50990043629041,66.47275981653429,12.037140619756125,21.490099563709585
11100204,11,10,02,04,7055,2373,5528,4682,846,1527,100.0,33.63571934798016,78.3557760453579,66.36428065201984,11.99149539333806,21.644223954642097
11100205,11,10,02,05,6133,1788,4927,4345,582,1206,100.0,29.153758356432412,80.33588781999022,70.84624164356758,9.489646176422632,19.66411218000978
11100206,11,10,02,06,7604,2234,5966,5370,596,1638,100.0,29.379274066280903,78.45870594423987,70.6207259337191,7.837980010520779,21.541294055760126
11100307,11,10,03,07,11724,3588,9539,8136,1403,2185,100.0,30.60388945752303,81.36301603548277,69.39611054247698,11.9669054930058,18.636983964517228
11100308,11,10,03,08,9573,2783,7773,6790,983,1800,100.0,29.07134649535151,81.19711689125666,70.92865350464848,10.268463386608168,18.80288310874334
11100309,11,10,03,09,5996,1379,5005,4617,388,991,100.0,22.99866577718479,83.47231487658439,77.00133422281522,6.470980653769179,16.527685123415612
11200410,11,20,04,10,10046,3099,7746,6947,799,2300,100.0,30.84809874576946,77.10531554847701,69.15190125423054,7.953414294246467,22.894684451522995
11200411,11,20,04,11,6800,1575,5826,5225,601,974,100.0,23.161764705882355,85.6764705882353,76.83823529411765,8.838235294117647,14.323529411764707
11200512,11,20,05,12,3860,749,3277,3111,166,583,100.0,19.40414507772021,84.89637305699482,80.5958549222798,4.300518134715025,15.10362694300518
11200513,11,20,05,13,10112,2800,7927,7312,615,2185,100.0,27.689873417721518,78.39200949367088,72.31012658227847,6.0818829113924044,21.607990506329113
11200514,11,20,05,14,15428,4571,12506,10857,1649,2922,100.0,29.627949183303087,81.06040964480165,70.37205081669691,10.688358828104745,18.93959035519834
11200515,11,20,05,15,4119,856,3653,3263,390,466,100.0,20.78174314153921,88.68657441126487,79.21825685846079,9.468317552804079,11.313425588735129
11300616,11,30,06,16,5998,2143,4681,3855,826,1317,100.0,35.72857619206402,78.04268089363121,64.27142380793597,13.771257085695233,21.95731910636879
11300617,11,30,06,17,4254,1101,3643,3153,490,611,100.0,25.881523272214384,85.63704748472027,74.1184767277856,11.51857075693465,14.362952515279737
11300618,11,30,06,18,3686,1008,2993,2678,315,693,100.0,27.34671730873576,81.19913185024417,72.65328269126424,8.545849158979923,18.800868149755836
11300619,11,30,06,19,8388,2839,6468,5549,919,1920,100.0,33.84597043395326,77.1101573676681,66.15402956604673,10.956127801621363,22.889842632331902
11300620,11,30,06,20,11235,3823,8827,7412,1415,2408,100.0,34.027592345349355,78.56697819314643,65.97240765465064,12.594570538495772,21.433021806853585
11300721,11,30,07,21,5243,3231,2321,2012,309,2922,100.0,61.62502384131222,44.26854854091169,38.37497615868777,5.893572382223917,55.73145145908831
11300722,11,30,07,22,10089,2497,8663,7592,1071,1426,100.0,24.749727425909406,85.86579442957677,75.25027257409059,10.615521855486174,14.134205570423234
11300723,11,30,07,23,2285,1479,1035,806,229,1250,100.0,64.72647702407002,45.29540481400438,35.27352297592998,10.021881838074398,54.70459518599562
11300724,11,30,07,24,3995,1048,3288,2947,341,707,100.0,26.23279098873592,82.30287859824782,73.76720901126407,8.53566958698373,17.69712140175219
11300725,11,30,07,25,9771,2180,8331,7591,740,1440,100.0,22.310920069593696,85.26251151366287,77.68907993040631,7.573431583256575,14.737488486337119
11300826,11,30,08,26,9851,3651,7528,6200,1328,2323,100.0,37.06222718505735,76.41863770175617,62.93777281494265,13.48086488681352,23.581362298243832
11400927,11,40,09,27,4212,1050,3536,3162,374,676,100.0,24.92877492877493,83.9506172839506,75.07122507122507,8.879392212725547,16.049382716049383
11400928,11,40,09,28,2383,754,1865,1629,236,518,100.0,31.640788921527484,78.26269408308855,68.35921107847251,9.90348300461603,21.737305916911456
11400929,11,40,09,29,16154,4264,13099,11890,1209,3055,100.0,26.39593908629442,81.08827534975858,73.60406091370558,7.48421443605299,18.91172465024143
11400930,11,40,09,30,4664,761,4217,3903,314,447,100.0,16.31646655231561,90.41595197255575,83.68353344768438,6.732418524871354,9.584048027444254
11400931,11,40,09,31,6743,1814,5559,4929,630,1184,100.0,26.90197241583865,82.44104997775472,73.09802758416136,9.343022393593357,17.55895002224529
11401032,11,40,10,32,5942,2171,4347,3771,576,1595,100.0,36.53651969033995,73.15718613261528,63.46348030966005,9.693705822955234,26.84281386738472
11401033,11,40,10,33,6728,2490,5233,4238,995,1495,100.0,37.00951248513674,77.7794292508918,62.99048751486326,14.788941736028537,22.220570749108205
11401034,11,40,10,34,3310,1044,2587,2266,321,723,100.0,31.540785498489427,78.1570996978852,68.45921450151057,9.697885196374623,21.842900302114803
11401135,11,40,11,35,10496,3252,8450,7244,1206,2046,100.0,30.98323170731707,80.50685975609755,69.01676829268293,11.490091463414634,19.49314024390244
11401136,11,40,11,36,8041,1790,6688,6251,437,1353,100.0,22.260912821788335,83.17373461012312,77.73908717821166,5.434647431911454,16.82626538987688
11401137,11,40,11,37,8693,2835,6908,5858,1050,1785,100.0,32.61244679627286,79.46623720234672,67.38755320372714,12.078683998619578,20.533762797653285
11501238,11,50,12,38,4254,945,3704,3309,395,550,100.0,22.214386459802537,87.07099200752234,77.78561354019746,9.28537846732487,12.929007992477667
11501339,11,50,13,39,10271,2302,8664,7969,695,1607,100.0,22.412618050822704,84.35400642585921,77.58738194917728,6.766624476681921,15.645993574140785
11501340,11,50,13,40,10543,1346,9842,9197,645,701,100.0,12.766764677985392,93.35103860381295,87.23323532201461,6.117803281798349,6.648961396187043
11501341,11,50,13,41,7343,1126,6712,6217,495,631,100.0,15.334332016886831,91.40678196922238,84.66566798311317,6.7411139861092195,8.59321803077761
12100101,12,10,01,01,10927,6061,7250,4866,2384,3677,100.0,55.468106525121264,66.34940971904457,44.53189347487874,21.817516244165827,33.650590280955434
12100102,12,10,01,02,9911,5009,6800,4902,1898,3111,100.0,50.53980425789527,68.61063464837049,49.46019574210474,19.150438906265766,31.3893653516295
12100103,12,10,01,03,7624,3407,5640,4217,1423,1984,100.0,44.68782791185729,73.9769150052466,55.31217208814271,18.664742917103883,26.02308499475341
12100204,12,10,02,04,8844,4200,6467,4644,1823,2377,100.0,47.4898236092266,73.12302125734962,52.51017639077341,20.61284486657621,26.876978742650387
12100205,12,10,02,05,14024,6555,10207,7469,2738,3817,100.0,46.741300627495725,72.78237307472904,53.25869937250428,19.52367370222476,27.217626925270967
12100206,12,10,02,06,4634,1515,3810,3119,691,824,100.0,32.69313767803194,82.21838584376349,67.30686232196807,14.911523521795425,17.781614156236515
12200307,12,20,03,07,2727,1098,2040,1629,411,687,100.0,40.26402640264026,74.80748074807481,59.73597359735974,15.071507150715071,25.192519251925194
12200308,12,20,03,08,5644,2469,4313,3175,1138,1331,100.0,43.745570517363575,76.41743444365699,56.254429482636425,20.163004961020555,23.58256555634302
12200309,12,20,03,09,10740,5819,7087,4921,2166,3653,100.0,54.180633147113596,65.98696461824953,45.819366852886404,20.16759776536313,34.01303538175047
12200310,12,20,03,10,8241,4985,5229,3256,1973,3012,100.0,60.49023176798932,63.45103749544958,39.50976823201068,23.9412692634389,36.54896250455042
12200411,12,20,04,11,364,257,199,107,92,165,100.0,70.6043956043956,54.670329670329664,29.395604395604398,25.274725274725274,45.32967032967033
12200412,12,20,04,12,6313,2191,5123,4122,1001,1190,100.0,34.70616188816727,81.15000792016474,65.29383811183273,15.856169808332012,18.84999207983526
12200413,12,20,04,13,8016,3333,6216,4683,1533,1800,100.0,41.57934131736527,77.54491017964071,58.42065868263473,19.124251497005986,22.45508982035928
12200414,12,20,04,14,1407,372,1219,1035,184,188,100.0,26.439232409381663,86.63823738450604,73.56076759061834,13.077469793887705,13.361762615493959
12200515,12,20,05,15,10928,2591,9411,8337,1074,1517,100.0,23.7097364568082,86.11822840409957,76.2902635431918,9.82796486090776,13.881771595900439
12400616,12,40,06,16,5973,847,5624,5126,498,349,100.0,14.180478821362799,94.1570400133936,85.8195211786372,8.337518834756404,5.842959986606395
12400617,12,40,06,17,6822,946,6469,5876,593,353,100.0,13.866901201993551,94.82556435063032,86.13309879800644,8.692465552623863,5.174435649369687
12400618,12,40,06,18,3744,598,3507,3146,361,237,100.0,15.972222222222221,93.6698717948718,84.02777777777779,9.642094017094017,6.330128205128204
12400619,12,40,06,19,7706,1097,7218,6609,609,488,100.0,14.235660524266805,93.66727225538541,85.7643394757332,7.902932779652219,6.332727744614585
12400720,12,40,07,20,8592,1135,8157,7457,700,435,100.0,13.20996275605214,94.93715083798882,86.79003724394786,8.147113594040968,5.062849162011173
12400721,12,40,07,21,8000,1157,7481,6843,638,519,100.0,14.4625,93.5125,85.5375,7.9750000000000005,6.4875
12400722,12,40,07,22,8562,1211,8006,7351,655,556,100.0,14.143891614108853,93.50619014249007,85.85610838589115,7.650081756598926,6.493809857509928
12400723,12,40,07,23,8096,1295,7490,6801,689,606,100.0,15.995553359683795,92.51482213438736,84.00444664031622,8.510375494071146,7.485177865612648
12500824,12,50,08,24,9670,1588,8898,8082,816,772,100.0,16.42192347466391,92.01654601861428,83.57807652533609,8.438469493278179,7.98345398138573
12500825,12,50,08,25,6735,1865,5492,4870,622,1243,100.0,27.69116555308092,81.54417223459541,72.30883444691908,9.235337787676318,18.455827765404603
12500926,12,50,09,26,5071,1428,4246,3643,603,825,100.0,28.160126207848553,83.73101952277658,71.83987379215145,11.891145730625123,16.268980477223426
12500927,12,50,09,27,6355,1537,5615,4818,797,740,100.0,24.185680566483082,88.35562549173879,75.81431943351691,12.541306058221874,11.644374508261212
12500928,12,50,09,28,5148,1011,4688,4137,551,460,100.0,19.63869463869464,91.06449106449107,80.36130536130536,10.703185703185703,8.935508935508937
12500929,12,50,09,29,5147,882,4824,4265,559,323,100.0,17.136195842238198,93.7244997085681,82.8638041577618,10.860695550806295,6.275500291431903
12500930,12,50,09,30,10181,3627,7795,6554,1241,2386,100.0,35.625184166584816,76.56418819369414,64.37481583341518,12.18937236027895,23.435811806305864
12601031,12,60,10,31,3263,964,2820,2299,521,443,100.0,29.543365001532333,86.4235366227398,70.45663499846768,15.966901624272142,13.57646337726019
12601032,12,60,10,32,5910,2986,4040,2924,1116,1870,100.0,50.524534686971236,68.35871404399323,49.475465313028764,18.883248730964468,31.64128595600677
12601133,12,60,11,33,11520,6043,8469,5477,2992,3051,100.0,52.45659722222222,73.515625,47.54340277777778,25.972222222222225,26.484375
12601134,12,60,11,34,15181,7066,11607,8115,3492,3574,100.0,46.545023384493774,76.45741387260391,53.454976615506226,23.00243725709769,23.54258612739609
12601235,12,60,12,35,10583,6123,7339,4460,2879,3244,100.0,57.85694037607484,69.3470660493244,42.14305962392516,27.204006425399225,30.65293395067561
12601236,12,60,12,36,3127,1346,2555,1781,774,572,100.0,43.044451551007356,81.70770706747682,56.955548448992644,24.75215861848417,18.292292932523186
