id,district_id,forecast_area_id,district_region_id,planning_area_id,inhabitants,inhabitants_with_migration_background,inhabitants_germans,inhabitants_germans_without_migration_background,inhabitants_germans_with_migration_background,inhabitants_foreigners,inhabitants_percentage,inhabitants_with_migration_background_percentage,inhabitants_germans_percentage,inhabitants_germans_without_migration_background_percentage,inhabitants_germans_with_migration_background_percentage,inhabitants_foreigners_percentage
01100101,01,10,01,01,3406,2103,1988,1303,685,1418,100.0,61.743981209630064,58.36758661186142,38.256018790369936,20.111567821491487,41.63241338813858
01100102,01,10,01,02,1816,1214,913,602,311,903,100.0,66.85022026431719,50.27533039647577,33.14977973568282,17.12555066079295,49.72466960352423
01100103,01,10,01,03,5333,3182,3393,2151,1242,1940,100.0,59.6662291393212,63.62272642040128,40.33377086067879,23.28895555972248,36.37727357959872
01100104,01,10,01,04,4694,3075,2859,1619,1240,1835,100.0,65.50916063059225,60.90754154239455,34.49083936940775,26.41670217298679,39.09245845760545
01100205,01,10,02,05,2784,1811,1440,973,467,1344,100.0,65.05028735632183,51.724137931034484,34.94971264367816,16.774425287356323,48.275862068965516
01100206,01,10,02,06,1806,971,1143,835,308,663,100.0,53.76522702104097,63.2890365448505,46.23477297895903,17.05426356589147,36.7109634551495
01100207,01,10,02,07,8481,4506,5529,3975,1554,2952,100.0,53.130527060488156,65.19278386982667,46.86947293951185,18.323310930314822,34.80721613017333
01100308,01,10,03,08,7113,3246,4807,3867,940,2306,100.0,45.63475326866301,67.58048643329116,54.36524673133699,13.215239701954168,32.419513566708844
01100309,01,10,03,09,12307,5125,8977,7182,1795,3330,100.0,41.6429674169172,72.94222800032502,58.3570325830828,14.58519541724222,27.057771999674983
01100310,01,10,03,10,10045,5070,6411,4975,1436,3634,100.0,50.47287207565954,63.82279741164758,49.52712792434047,14.295669487307116,36.177202588352415
01100311,01,10,03,11,9205,4434,6296,4771,1525,2909,100.0,48.169473112438894,68.39760999456817,51.83052688756111,16.56708310700706,31.60239000543183
01100312,01,10,03,12,9877,4652,6784,5225,1559,3093,100.0,47.09932165637339,68.68482332692113,52.90067834362661,15.784144983294524,31.31517667307887
01100313,01,10,03,13,11047,5305,7408,5742,1666,3639,100.0,48.02208744455508,67.05893002625147,51.97791255544492,15.081017470806554,32.941069973748526
01100414,01,10,04,14,5393,2998,3152,2395,757,2241,100.0,55.590580381976636,58.446133877248286,44.409419618023364,14.036714259224922,41.553866122751714
01100415,01,10,04,15,12833,5308,9289,7525,1764,3544,100.0,41.3621133016442,72.38369827787736,58.6378866983558,13.745811579521547,27.616301722122653
01100416,01,10,04,16,13290,5438,9717,7852,1865,3573,100.0,40.917983446200154,73.11512415349887,59.08201655379985,14.03310759969902,26.884875846501128
01200517,01,20,05,17,3733,2190,2205,1543,662,1528,100.0,58.665952317171175,59.06777390838468,41.334047682828825,17.733726225555856,40.93222609161532
01200518,01,20,05,18,6897,4397,3860,2500,1360,3037,100.0,63.7523560968537,55.966362186457886,36.2476439031463,19.718718283311585,44.03363781354212
01200519,01,20,05,19,9080,4968,5711,4112,1599,3369,100.0,54.713656387665196,62.89647577092511,45.286343612334804,17.610132158590307,37.10352422907489
01200520,01,20,05,20,9421,4553,6655,4868,1787,2766,100.0,48.328202950854475,70.64005944167285,51.67179704914553,18.968262392527333,29.359940558327143
01200521,01,20,05,21,5192,3090,3241,2102,1139,1951,100.0,59.514637904468415,62.422958397534664,40.485362095531585,21.937596302003083,37.577041602465336
01200522,01,20,05,22,11351,4105,9044,7246,1798,2307,100.0,36.16421460664259,79.6757994890318,63.83578539335741,15.84001409567439,20.324200510968197
01200623,01,20,06,23,10766,5544,7381,5222,2159,3385,100.0,51.49544863459038,68.55842467025822,48.50455136540962,20.053873304848597,31.441575329741777
01200624,01,20,06,24,6111,4267,3126,1844,1282,2985,100.0,69.82490590738013,51.153657339224345,30.175094092619865,20.978563246604484,48.84634266077565
01200625,01,20,06,25,6877,4137,4546,2740,1806,2331,100.0,60.157045223207795,66.10440599098443,39.842954776792205,26.261451214192235,33.89559400901556
01200626,01,20,06,26,5840,2522,4322,3318,1004,1518,100.0,43.18493150684932,74.0068493150685,56.81506849315069,17.191780821917806,25.993150684931503
01200627,01,20,06,27,3219,2081,2170,1138,1032,1049,100.0,64.64740602671637,67.41223982603293,35.35259397328363,32.059645852749306,32.58776017396707
01200628,01,20,06,28,3252,1424,2482,1828,654,770,100.0,43.788437884378844,76.32226322263223,56.21156211562116,20.11070110701107,23.677736777367777
01200629,01,20,06,29,5926,2904,3897,3022,875,2029,100.0,49.00438744515693,65.76105298683767,50.99561255484306,14.7654404319946,34.23894701316234
01300730,01,30,07,30,7917,5702,4195,2215,1980,3722,100.0,72.02223064292029,52.987242642415055,27.9777693570797,25.009473285335353,47.012757357584945
01300731,01,30,07,31,8558,5039,5323,3519,1804,3235,100.0,58.88057957466698,62.19911194204253,41.11942042533302,21.079691516709513,37.800888057957465
01300732,01,30,07,32,9758,6125,5870,3633,2237,3888,100.0,62.769010043041604,60.15576962492314,37.230989956958396,22.92477966796475,39.84423037507686
01300733,01,30,07,33,11486,7142,7104,4344,2760,4382,100.0,62.18004527250566,61.84920773115097,37.81995472749434,24.029253003656624,38.15079226884903
01300834,01,30,08,34,14323,9633,9901,4690,5211,4422,100.0,67.25546324094115,69.12657962717307,32.74453675905885,36.382042868114226,30.87342037282692
01300835,01,30,08,35,10590,6403,7260,4187,3073,3330,100.0,60.462700661000945,68.55524079320114,39.537299338999055,29.017941454202077,31.444759206798867
01300836,01,30,08,36,14727,9585,8839,5142,3697,5888,100.0,65.08453860256671,60.01901269776601,34.91546139743328,25.10355130033272,39.98098730223399
01400937,01,40,09,37,10614,5234,7455,5380,2075,3159,100.0,49.31222913133597,70.23742227247031,50.68777086866403,19.549651403806294,29.762577727529678
01400938,01,40,09,38,9666,5133,6375,4533,1842,3291,100.0,53.10366232153941,65.9528243327126,46.89633767846058,19.056486654252016,34.0471756672874
01400939,01,40,09,39,5952,3153,3756,2799,957,2196,100.0,52.97379032258065,63.10483870967742,47.02620967741936,16.078629032258064,36.895161290322584
01400940,01,40,09,40,6773,2541,5625,4232,1393,1148,100.0,37.51661006939318,83.050346965894,62.483389930606826,20.56695703528717,16.94965303410601
01400941,01,40,09,41,3783,1753,2811,2030,781,972,100.0,46.33888448321438,74.30610626486916,53.66111551678562,20.64499074808353,25.693893735130846
01400942,01,40,09,42,8662,4717,5448,3945,1503,3214,100.0,54.45624567074579,62.89540521819441,45.54375432925421,17.3516508889402,37.10459478180559
01401043,01,40,10,43,7671,5184,4514,2487,2027,3157,100.0,67.57919436840048,58.8450006518055,32.42080563159953,26.42419502020597,41.1549993481945
01401044,01,40,10,44,10110,6884,5661,3226,2435,4449,100.0,68.09099901088031,55.99406528189911,31.909000989119683,24.085064292779425,44.00593471810089
01401045,01,40,10,45,5539,4014,3071,1525,1546,2468,100.0,72.46795450442318,55.44322079797798,27.532045495576817,27.911175302401155,44.55677920202202
01401046,01,40,10,46,8737,4390,5948,4347,1601,2789,100.0,50.246079890122466,68.0782877417878,49.753920109877534,18.324367631910267,31.921712258212203
01401047,01,40,10,47,7829,5449,3887,2380,1507,3942,100.0,69.600204368374,49.6487418571976,30.399795631626002,19.248946225571594,50.3512581428024
01401048,01,40,10,48,9263,5587,5655,3676,1979,3608,100.0,60.315232646011005,61.049336068228435,39.68476735398899,21.36456871423945,38.950663931771565
01401049,01,40,10,49,6639,4028,3906,2611,1295,2733,100.0,60.67178791986745,58.83416177135111,39.32821208013255,19.505949691218557,41.165838228648894
02100101,02,10,01,01,6216,4364,3684,1852,1832,2532,100.0,70.20592020592021,59.26640926640927,29.794079794079792,29.472329472329474,40.73359073359074
02100102,02,10,01,02,8637,6138,5566,2499,3067,3071,100.0,71.06634248002779,64.44367257149473,28.93365751997221,35.51001505152252,35.55632742850527
02100103,02,10,01,03,5379,3418,3694,1961,1733,1685,100.0,63.543409555679496,68.67447480944413,36.45659044432051,32.21788436512363,31.325525190555865
02100104,02,10,01,04,5627,3891,3506,1736,1770,2121,100.0,69.14874711213791,62.30673538297494,30.851252887862096,31.455482495112847,37.69326461702506
02100105,02,10,01,05,9495,6779,6215,2716,3499,3280,100.0,71.39547130068456,65.45550289626118,28.60452869931543,36.850974196945764,34.544497103738806
02100106,02,10,01,06,4993,3263,3371,1730,1641,1622,100.0,65.35149208892449,67.51452032845985,34.648507911075505,32.86601241738434,32.485479671540155
02200207,02,20,02,07,2242,922,1710,1320,390,532,100.0,41.12399643175736,76.27118644067797,58.87600356824264,17.395182872435324,23.728813559322035
02200208,02,20,02,08,5853,2610,4210,3243,967,1643,100.0,44.59251665812404,71.9289253374338,55.40748334187596,16.521441995557833,28.071074662566204
02200209,02,20,02,09,10845,4476,8165,6369,1796,2680,100.0,41.27247579529737,75.28815122176118,58.72752420470263,16.56062701705855,24.71184877823882
02200210,02,20,02,10,12225,5373,8883,6852,2031,3342,100.0,43.95092024539877,72.66257668711657,56.04907975460123,16.613496932515336,27.337423312883434
02200211,02,20,02,11,14689,6228,11013,8461,2552,3676,100.0,42.3990741371094,74.97447069235483,57.6009258628906,17.373544829464223,25.02552930764518
02200212,02,20,02,12,8537,4338,6230,4199,2031,2307,100.0,50.81410331498184,72.97645542930772,49.18589668501816,23.790558744289562,27.02354457069228
02200213,02,20,02,13,10142,4652,7176,5490,1686,2966,100.0,45.86866495760205,70.7552750936699,54.13133504239796,16.623940051271937,29.24472490633011
02300314,02,30,03,14,7479,4574,4741,2905,1836,2738,100.0,61.157908811338416,63.39082765075544,38.842091188661584,24.548736462093864,36.60917234924455
02300315,02,30,03,15,8530,4888,5638,3642,1996,2892,100.0,57.30363423212192,66.09613130128956,42.69636576787808,23.39976553341149,33.90386869871043
02300316,02,30,03,16,4215,2089,2967,2126,841,1248,100.0,49.56109134045077,70.39145907473309,50.43890865954923,19.952550415183868,29.6085409252669
02300417,02,30,04,17,8242,4561,5431,3681,1750,2811,100.0,55.33851007037127,65.89420043678719,44.66148992962873,21.232710507158455,34.10579956321281
02300418,02,30,04,18,7653,3680,5371,3973,1398,2282,100.0,48.08571801907748,70.18162811969162,51.91428198092252,18.26734613876911,29.818371880308376
02300419,02,30,04,19,10710,5541,7130,5169,1961,3580,100.0,51.73669467787116,66.57329598506068,48.26330532212885,18.30999066293184,33.426704014939304
02400520,02,40,05,20,5673,2020,4464,3653,811,1209,100.0,35.60726247135555,78.68852459016394,64.39273752864446,14.295787061519476,21.311475409836063
02400521,02,40,05,21,7867,2794,6127,5073,1054,1740,100.0,35.515444260836404,77.88229312317276,64.4845557391636,13.397737384009153,22.117706876827253
02400522,02,40,05,22,11223,3457,9020,7766,1254,2203,100.0,30.802815646440347,80.37066737948855,69.19718435355966,11.173483025928896,19.62933262051145
02400623,02,40,06,23,13383,6435,9184,6948,2236,4199,100.0,48.08338937457969,68.62437420608234,51.91661062542031,16.707763580662032,31.375625793917656
02400624,02,40,06,24,11459,4056,8512,7403,1109,2947,100.0,35.39575879221572,74.282223579719,64.60424120778427,9.677982371934723,25.717776420281
02400625,02,40,06,25,1093,754,440,339,101,653,100.0,68.98444647758463,40.256175663311986,31.015553522415367,9.240622140896615,59.743824336688014
02500726,02,50,07,26,9247,3512,6776,5735,1041,2471,100.0,37.979885368227535,73.2778198334595,62.02011463177247,11.257705201687033,26.7221801665405
02500727,02,50,07,27,6586,2447,4903,4139,764,1683,100.0,37.154570300637715,74.44579410871546,62.845429699362285,11.600364409353174,25.554205891284543
02500728,02,50,07,28,10036,3410,7642,6626,1016,2394,100.0,33.977680350737344,76.14587485053806,66.02231964926266,10.123555201275408,23.85412514946194
02500729,02,50,07,29,5444,1914,4211,3530,681,1233,100.0,35.157972079353414,77.3512123438648,64.84202792064659,12.509184423218223,22.648787656135195
02500830,02,50,08,30,3914,1572,2809,2342,467,1105,100.0,40.1635155850792,71.76801226366888,59.8364844149208,11.931527848748084,28.23198773633112
02500831,02,50,08,31,7841,3079,5666,4762,904,2175,100.0,39.26795051651575,72.26119117459507,60.73204948348425,11.529141691110828,27.73880882540492
02500832,02,50,08,32,9115,3915,6329,5200,1129,2786,100.0,42.95117937465716,69.43499725726824,57.04882062534284,12.386176631925398,30.56500274273176
02500833,02,50,08,33,10186,3951,7215,6235,980,2971,100.0,38.78853328097389,70.83251521696447,61.21146671902612,9.621048497938347,29.16748478303554
02500834,02,50,08,34,11444,4112,8596,7332,1264,2848,100.0,35.93149248514506,75.11359664452989,64.06850751485494,11.045089129674938,24.886403355470115
02500835,02,50,08,35,7931,3235,5601,4696,905,2330,100.0,40.78930777959904,70.62161139831042,59.210692220400965,11.410919177909468,29.37838860168957
02500836,02,50,08,36,4863,1170,4323,3693,630,540,100.0,24.05922270203578,88.89574336829118,75.94077729796422,12.95496607032696,11.104256631708822
03100101,03,10,01,01,4592,831,4072,3761,311,520,100.0,18.096689895470384,88.67595818815332,81.90331010452961,6.772648083623693,11.32404181184669
03100102,03,10,01,02,3180,885,2511,2295,216,669,100.0,27.830188679245282,78.9622641509434,72.16981132075472,6.7924528301886795,21.037735849056606
03100103,03,10,01,03,8856,1674,7652,7182,470,1204,100.0,18.902439024390244,86.40469738030714,81.09756097560977,5.30713640469738,13.595302619692864
03200204,03,20,02,04,2113,199,2008,1914,94,105,100.0,9.417889256980597,95.03076194983436,90.5821107430194,4.448651206814954,4.969238050165641
03200205,03,20,02,05,8751,1488,7924,7263,661,827,100.0,17.003770997600274,90.54965146840361,82.99622900239973,7.553422466003886,9.45034853159639
03200206,03,20,02,06,6406,1335,5548,5071,477,858,100.0,20.839837652201062,86.60630658757414,79.16016234779893,7.446144239775212,13.39369341242585
03200207,03,20,02,07,11427,2048,10265,9379,886,1162,100.0,17.92246433884659,89.83110177649426,82.0775356611534,7.75356611534086,10.168898223505732
03200308,03,20,03,08,5193,702,4896,4491,405,297,100.0,13.518197573656845,94.28076256499133,86.48180242634315,7.798960138648179,5.719237435008666
03200309,03,20,03,09,5286,890,4810,4396,414,476,100.0,16.83692773363602,90.99508134695422,83.16307226636398,7.832009080590238,9.004918653045783
03200310,03,20,03,10,8018,1286,7458,6732,726,560,100.0,16.038912446994264,93.01571464205539,83.96108755300574,9.054627089049639,6.984285357944625
03300411,03,30,04,11,11592,2526,10028,9066,962,1564,100.0,21.790890269151138,86.5079365079365,78.20910973084885,8.298826777087646,13.492063492063492
03300412,03,30,04,12,5137,504,4941,4633,308,196,100.0,9.811173836869768,96.18454350788397,90.18882616313023,5.995717344753747,3.8154564921160214
03300413,03,30,04,13,3092,273,2979,2819,160,113,100.0,8.829236739974126,96.34540750323414,91.17076326002588,5.17464424320828,3.6545924967658476
03300514,03,30,05,14,6860,651,6548,6209,339,312,100.0,9.489795918367347,95.45189504373178,90.51020408163265,4.941690962099125,4.548104956268221
03300515,03,30,05,15,50,0,50,50,0,0,100.0,0.0,100.0,100.0,0.0,0.0
03300516,03,30,05,16,7982,1765,6765,6217,548,1217,100.0,22.112252568278628,84.75319468804811,77.88774743172138,6.8654472563267355,15.246805311951892
03300517,03,30,05,17,1118,52,1100,1066,34,18,100.0,4.651162790697675,98.38998211091234,95.34883720930233,3.041144901610018,1.6100178890876566
03400618,03,40,06,18,4854,1073,4486,3781,705,368,100.0,22.105480016481252,92.41862381540997,77.89451998351875,14.524103831891225,7.581376184590029
03400619,03,40,06,19,10371,2084,9312,8287,1025,1059,100.0,20.09449426284833,89.78883424934915,79.90550573715167,9.883328512197474,10.211165750650855
03400620,03,40,06,20,3545,696,3199,2849,350,346,100.0,19.633286318758817,90.23977433004231,80.36671368124118,9.873060648801129,9.760225669957686
03400721,03,40,07,21,11607,2538,10224,9069,1155,1383,100.0,21.866115275264928,88.08477642801758,78.13388472473507,9.950891703282503,11.915223571982423
03400722,03,40,07,22,3610,601,3330,3009,321,280,100.0,16.64819944598338,92.24376731301939,83.35180055401662,8.89196675900277,7.756232686980609
03400723,03,40,07,23,7067,1685,6096,5382,714,971,100.0,23.843214942691382,86.2600820716004,76.15678505730862,10.10329701429178,13.739917928399603
03400724,03,40,07,24,7584,1105,6970,6479,491,614,100.0,14.570147679324894,91.90400843881856,85.42985232067511,6.474156118143459,8.095991561181433
03400725,03,40,07,25,7416,1023,6842,6393,449,574,100.0,13.794498381877023,92.25997842502697,86.20550161812298,6.054476806903991,7.7400215749730314
03400826,03,40,08,26,6789,1492,5726,5297,429,1063,100.0,21.976727058476946,84.34231845632641,78.02327294152305,6.319045514803358,15.65768154367359
03400827,03,40,08,27,9659,2412,8105,7247,858,1554,100.0,24.971529143803707,83.9113779894399,75.0284708561963,8.882907133243608,16.0886220105601
03400828,03,40,08,28,4818,1246,3947,3572,375,871,100.0,25.861353258613534,81.9219593192196,74.13864674138647,7.783312577833127,18.078040680780408
03400829,03,40,08,29,5544,1036,4919,4508,411,625,100.0,18.68686868686869,88.72655122655124,81.31313131313132,7.413419913419913,11.273448773448774
03400830,03,40,08,30,9232,1575,8290,7657,633,942,100.0,17.060225303292896,89.79636048526864,82.9397746967071,6.856585788561525,10.20363951473137
03400831,03,40,08,31,0,0,0,0,0,0,0.0,0.0,0.0,0.0,0.0,0.0
03500932,03,50,09,32,5834,1365,4754,4469,285,1080,100.0,23.39732601988344,81.48782996229002,76.60267398011655,4.885155982173466,18.51217003770998
03500933,03,50,09,33,7632,1379,6769,6253,516,863,100.0,18.06865828092243,88.69234800838575,81.93134171907757,6.761006289308176,11.307651991614255
03500934,03,50,09,34,10203,2854,8272,7349,923,1931,100.0,27.972165049495246,81.07419386454964,72.02783495050475,9.04635891404489,18.925806135450358
03500935,03,50,09,35,6585,1814,5385,4771,614,1200,100.0,27.54745634016705,81.77676537585421,72.45254365983295,9.324221716021261,18.223234624145785
03500936,03,50,09,36,9819,2205,8387,7614,773,1432,100.0,22.45646196150321,85.41603014563601,77.54353803849679,7.87249210713922,14.583969854363987
03501037,03,50,10,37,8560,1794,7329,6766,563,1231,100.0,20.957943925233643,85.61915887850468,79.04205607476635,6.577102803738318,14.380841121495328
03501038,03,50,10,38,7422,1233,6596,6189,407,826,100.0,16.612772837510107,88.87092427917004,83.38722716248989,5.4836971166801405,11.129075720829965
03601139,03,60,11,39,3751,1340,2862,2411,451,889,100.0,35.72380698480405,76.29965342575314,64.27619301519594,12.023460410557185,23.700346574246865
03601140,03,60,11,40,5902,1873,4661,4029,632,1241,100.0,31.735005083022706,78.97322941375805,68.2649949169773,10.708234496780753,21.026770586241952
03601141,03,60,11,41,6585,2273,5047,4312,735,1538,100.0,34.51784358390281,76.64388762338649,65.4821564160972,11.161731207289293,23.356112376613517
03601142,03,60,11,42,10748,3901,8050,6847,1203,2698,100.0,36.29512467435802,74.8976553777447,63.704875325641986,11.192780052102718,25.102344622255302
03601243,03,60,12,43,6987,2068,5634,4919,715,1353,100.0,29.597824531272366,80.63546586517819,70.40217546872763,10.23329039645055,19.364534134821813
03601244,03,60,12,44,7546,2100,6206,5446,760,1340,100.0,27.82931354359926,82.24224754836999,72.17068645640074,10.071561091969256,17.75775245163
03601245,03,60,12,45,12758,3638,10310,9120,1190,2448,100.0,28.51544129173852,80.81203950462455,71.48455870826147,9.327480796363066,19.18796049537545
03601346,03,60,13,46,5875,2171,4393,3704,689,1482,100.0,36.9531914893617,74.77446808510638,63.0468085106383,11.727659574468085,25.22553191489362
03601347,03,60,13,47,9376,3060,7427,6316,1111,1949,100.0,32.636518771331055,79.21288395904436,67.36348122866895,11.849402730375425,20.78711604095563
03601348,03,60,13,48,7419,2522,5749,4897,852,1670,100.0,33.99379970346408,77.49022779350317,66.00620029653592,11.484027496967245,22.509772206496834
03601449,03,60,14,49,9890,1996,8651,7894,757,1239,100.0,20.182002022244692,87.4721941354904,79.81799797775531,7.654196157735085,12.527805864509606
03601450,03,60,14,50,4116,1903,2555,2213,342,1561,100.0,46.23420796890185,62.074829931972786,53.76579203109816,8.309037900874635,37.92517006802721
03601451,03,60,14,51,6296,1952,4918,4344,574,1378,100.0,31.003811944091485,78.1130876747141,68.99618805590852,9.11689961880559,21.886912325285895
03601452,03,60,14,52,4412,1631,3269,2781,488,1143,100.0,36.96736174070716,74.09338168631007,63.03263825929284,11.060743427017226,25.90661831368994
03601453,03,60,14,53,3017,970,2488,2047,441,529,100.0,32.15114352005303,82.46602585349684,67.84885647994696,14.617169373549885,17.533974146503148
03701554,03,70,15,54,11385,4411,8502,6974,1528,2883,100.0,38.743961352657,74.67720685111989,61.25603864734299,13.421168203776897,25.32279314888011
03701555,03,70,15,55,7260,2431,5696,4829,867,1564,100.0,33.484848484848484,78.45730027548208,66.51515151515152,11.942148760330578,21.542699724517906
03701556,03,70,15,56,8636,3446,6280,5190,1090,2356,100.0,39.90273274664196,72.71885132005558,60.097267253358034,12.621584066697544,27.281148679944415
03701657,03,70,16,57,3216,1116,2463,2100,363,753,100.0,34.701492537313435,76.58582089552239,65.29850746268657,11.287313432835822,23.41417910447761
03701658,03,70,16,58,8395,2806,6534,5589,945,1861,100.0,33.42465753424658,77.83204288266825,66.57534246575342,11.25670041691483,22.167957117331746
03701659,03,70,16,59,9086,3169,7072,5917,1155,2014,100.0,34.877834030376405,77.83403037640326,65.12216596962361,12.711864406779661,22.165969623596744
03701660,03,70,16,60,12708,3690,10438,9018,1420,2270,100.0,29.036827195467424,82.13723638652817,70.96317280453258,11.174063581995593,17.86276361347183
04100101,04,10,01,01,11396,5762,7927,5634,2293,3469,100.0,50.561600561600564,69.55949455949457,49.438399438399436,20.12109512109512,30.44050544050544
04100102,04,10,01,02,7755,4375,5569,3380,2189,2186,100.0,56.41521598968408,71.81173436492585,43.58478401031592,28.22695035460993,28.188265635074146
04200203,04,20,02,03,1455,388,1265,1067,198,190,100.0,26.666666666666668,86.94158075601375,73.33333333333333,13.608247422680412,13.058419243986256
04200204,04,20,02,04,2841,960,2224,1881,343,617,100.0,33.7909186906019,78.28229496656107,66.2090813093981,12.07321365716297,21.717705033438932
04200205,04,20,02,05,2477,756,2057,1721,336,420,100.0,30.520791279773917,83.04400484457004,69.47920872022608,13.564796124343964,16.955995155429957
04200206,04,20,02,06,2846,773,2490,2073,417,356,100.0,27.160927617709063,87.49121574139143,72.83907238229094,14.652143359100492,12.508784258608575
04200207,04,20,02,07,3010,1088,2229,1922,307,781,100.0,36.14617940199336,74.0531561461794,63.85382059800665,10.199335548172757,25.9468438538206
04200308,04,20,03,08,6141,2185,4759,3956,803,1382,100.0,35.580524344569284,77.49552190197036,64.41947565543072,13.076046246539653,22.504478098029637
04200309,04,20,03,09,6784,1851,5861,4933,928,923,100.0,27.284787735849058,86.39445754716981,72.71521226415094,13.679245283018867,13.60554245283019
04200310,04,20,03,10,7618,2805,6082,4813,1269,1536,100.0,36.82068784457863,79.83722761879758,63.17931215542137,16.657915463376213,20.162772381202416
04200311,04,20,03,11,7237,2871,5528,4366,1162,1709,100.0,39.67113444797568,76.38524250379992,60.328865552024325,16.056376951775597,23.614757496200085
04300412,04,30,04,12,3687,1999,2270,1688,582,1417,100.0,54.2175210197993,61.56767019256848,45.7824789802007,15.785191212367778,38.432329807431515
04300413,04,30,04,13,10011,4757,7531,5254,2277,2480,100.0,47.5177304964539,75.22725002497252,52.4822695035461,22.74498052142643,24.77274997502747
04300414,04,30,04,14,10520,4041,8265,6479,1786,2255,100.0,38.41254752851711,78.56463878326996,61.5874524714829,16.977186311787072,21.435361216730037
04300415,04,30,04,15,6267,2399,4913,3868,1045,1354,100.0,38.279878729854794,78.39476623583852,61.7201212701452,16.674644965693314,21.60523376416148
04300416,04,30,04,16,11650,4671,8931,6979,1952,2719,100.0,40.09442060085837,76.66094420600858,59.90557939914163,16.755364806866954,23.339055793991417
04300517,04,30,05,17,9436,4436,6809,5000,1809,2627,100.0,47.01144552776601,72.15981348028826,52.98855447223399,19.17125900805426,27.84018651971174
04300518,04,30,05,18,5717,2612,4234,3105,1129,1483,100.0,45.68829805842225,74.05982158474724,54.31170194157775,19.748119643169495,25.940178415252756
04300619,04,30,06,19,8583,3838,6419,4745,1674,2164,100.0,44.7162996621228,74.78737038331586,55.28370033787719,19.50367004543866,25.212629616684147
04300620,04,30,06,20,3397,2029,2163,1368,795,1234,100.0,59.729172799528996,63.67382984986752,40.270827200471004,23.403002649396527,36.32617015013247
04300621,04,30,06,21,10501,5056,7650,5445,2205,2851,100.0,48.14779544805256,72.8502047424055,51.85220455194744,20.99800019045805,27.149795257594516
04300622,04,30,06,22,5150,2982,3487,2168,1319,1663,100.0,57.90291262135923,67.70873786407768,42.09708737864077,25.611650485436893,32.29126213592233
04300623,04,30,06,23,11938,6543,7811,5395,2416,4127,100.0,54.80817557379795,65.42972022114257,45.19182442620205,20.237895794940524,34.57027977885743
04300624,04,30,06,24,9175,4142,6606,5033,1573,2569,100.0,45.14441416893733,72.0,54.85558583106267,17.14441416893733,28.000000000000004
04400725,04,40,07,25,107,74,42,33,9,65,100.0,69.1588785046729,39.25233644859813,30.8411214953271,8.411214953271028,60.747663551401864
04400726,04,40,07,26,5298,2237,4089,3061,1028,1209,100.0,42.2234805587014,77.18006795016987,57.7765194412986,19.40354850887127,22.819932049830125
04400727,04,40,07,27,8251,3319,6477,4932,1545,1774,100.0,40.22542722094292,78.49957580899284,59.77457277905709,18.725003029935767,21.50042419100715
04400728,04,40,07,28,3066,1132,2479,1934,545,587,100.0,36.921069797782124,80.85453359425962,63.078930202217876,17.77560339204175,19.14546640574038
04400729,04,40,07,29,2832,1097,2266,1735,531,566,100.0,38.73587570621469,80.01412429378531,61.264124293785315,18.75,19.98587570621469
04400830,04,40,08,30,7100,2859,5636,4241,1395,1464,100.0,40.267605633802816,79.38028169014085,59.732394366197184,19.64788732394366,20.619718309859156
04400831,04,40,08,31,1510,438,1305,1072,233,205,100.0,29.00662251655629,86.42384105960265,70.99337748344371,15.43046357615894,13.57615894039735
04400832,04,40,08,32,6813,1727,5956,5086,870,857,100.0,25.348598268017025,87.42110670776458,74.65140173198297,12.769704975781593,12.578893292235433
04400833,04,40,08,33,4119,1524,3329,2595,734,790,100.0,36.99927166788055,80.82058752124301,63.00072833211945,17.819859189123573,19.17941247875698
04400834,04,40,08,34,3512,1140,2931,2372,559,581,100.0,32.46013667425968,83.45671981776765,67.53986332574033,15.916856492027334,16.543280182232344
04400835,04,40,08,35,10341,2929,8745,7412,1333,1596,100.0,28.324146600909,84.56628952712504,71.675853399091,12.890436128034038,15.433710472874965
04500936,04,50,09,36,5499,2479,4086,3020,1066,1413,100.0,45.08092380432806,74.30441898527005,54.91907619567195,19.38534278959811,25.695581014729953
04500937,04,50,09,37,7503,3131,5702,4372,1330,1801,100.0,41.72997467679595,75.9962681594029,58.27002532320405,17.726242836198853,24.003731840597094
04500938,04,50,09,38,7894,3657,5800,4237,1563,2094,100.0,46.32632379022042,73.4735241955916,53.67367620977957,19.799847985812008,26.526475804408413
04500939,04,50,09,39,6461,3049,4858,3412,1446,1603,100.0,47.1908373316824,75.18959913326111,52.8091626683176,22.380436464943507,24.810400866738895
04501040,04,50,10,40,5865,2589,4400,3276,1124,1465,100.0,44.14322250639386,75.02131287297527,55.85677749360614,19.164535379369138,24.978687127024724
04501041,04,50,10,41,5175,2262,3925,2913,1012,1250,100.0,43.710144927536234,75.84541062801932,56.289855072463766,19.555555555555557,24.154589371980677
04501042,04,50,10,42,3492,1964,2228,1528,700,1264,100.0,56.24284077892325,63.80297823596792,43.75715922107675,20.04581901489118,36.19702176403207
04501043,04,50,10,43,10890,4934,8124,5956,2168,2766,100.0,45.30762167125803,74.60055096418733,54.69237832874197,19.90817263544536,25.399449035812673
04501044,04,50,10,44,5224,2264,3916,2960,956,1308,100.0,43.33843797856049,74.96171516079633,56.661562021439515,18.300153139356816,25.038284839203673
04501045,04,50,10,45,9019,4286,6416,4733,1683,2603,100.0,47.5218982148797,71.13870717374432,52.4781017851203,18.660605388624017,28.86129282625568
04501146,04,50,11,46,4456,1917,3362,2539,823,1094,100.0,43.020646319569124,75.4488330341113,56.979353680430876,18.46947935368043,24.55116696588869
04501147,04,50,11,47,5471,2380,4110,3091,1019,1361,100.0,43.50210199232316,75.12337781027234,56.49789800767684,18.625479802595503,24.876622189727655
04501148,04,50,11,48,4291,1875,3262,2416,846,1029,100.0,43.69610813330226,76.01957585644372,56.30389186669774,19.71568398974598,23.98042414355628
04501149,04,50,11,49,9732,3956,7421,5776,1645,2311,100.0,40.64940402794903,76.25359638306617,59.35059597205097,16.903000411015206,23.746403616933826
04501150,04,50,11,50,3038,1169,2349,1869,480,689,100.0,38.47926267281106,77.3206056616195,61.52073732718893,15.799868334430547,22.67939433838051
04501151,04,50,11,51,7338,2397,6015,4941,1074,1323,100.0,32.665576451349146,81.97056418642681,67.33442354865086,14.63614063777596,18.02943581357318
04501152,04,50,11,52,6756,2968,5022,3788,1234,1734,100.0,43.931320307874486,74.33392539964476,56.06867969212552,18.26524570751924,25.666074600355238
04501153,04,50,11,53,7353,3301,5513,4052,1461,1840,100.0,44.89324085407317,74.97620019039847,55.10675914592683,19.869441044471646,25.02379980960152
05100101,05,10,01,01,4126,785,3814,3341,473,312,100.0,19.02569074163839,92.43819680077557,80.97430925836161,11.46388754241396,7.56180319922443
05100102,05,10,01,02,4264,1046,3670,3218,452,594,100.0,24.53095684803002,86.06941838649156,75.46904315196998,10.600375234521577,13.93058161350844
05100103,05,10,01,03,5922,2847,4204,3075,1129,1718,100.0,48.07497467071935,70.98953056399864,51.92502532928065,19.064505234718002,29.01046943600135
05100104,05,10,01,04,4955,2115,3877,2840,1037,1078,100.0,42.68415741675076,78.24419778002019,57.31584258324924,20.92835519677094,21.75580221997982
05100105,05,10,01,05,7511,1540,6789,5971,818,722,100.0,20.503261882572225,90.38743176674211,79.49673811742777,10.890693649314338,9.612568233257889
05100206,05,10,02,06,3552,1571,2681,1981,700,871,100.0,44.2286036036036,75.4786036036036,55.7713963963964,19.707207207207208,24.521396396396398
05100207,05,10,02,07,2298,661,2046,1637,409,252,100.0,28.764142732811138,89.03394255874673,71.23585726718886,17.79808529155788,10.966057441253264
05100208,05,10,02,08,10744,4973,7945,5771,2174,2799,100.0,46.28629932985853,73.9482501861504,53.71370067014147,20.234549516008933,26.05174981384959
05100209,05,10,02,09,11756,6230,8874,5526,3348,2882,100.0,52.99421571963253,75.48485879550869,47.00578428036747,28.479074515141207,24.51514120449132
05100210,05,10,02,10,7666,2960,5811,4706,1105,1855,100.0,38.612053222019306,75.8022436733629,61.387946777980694,14.414296895382206,24.197756326637098
05100211,05,10,02,11,6015,2074,5018,3941,1077,997,100.0,34.48046550290939,83.42477140482129,65.5195344970906,17.905236907730675,16.57522859517872
05100312,05,10,03,12,4030,1734,2911,2296,615,1119,100.0,43.0272952853598,72.2332506203474,56.9727047146402,15.260545905707195,27.766749379652605
05100313,05,10,03,13,6134,3330,4337,2804,1533,1797,100.0,54.28757743723508,70.70427127486143,45.712422562764914,24.991848712096512,29.29572872513857
05100314,05,10,03,14,7362,4453,4095,2909,1186,3267,100.0,60.48628090192882,55.62347188264059,39.51371909807118,16.109752784569412,44.37652811735941
05100315,05,10,03,15,6878,3187,4804,3691,1113,2074,100.0,46.33614422797325,69.84588543181157,53.66385577202675,16.18202965978482,30.15411456818843
05100316,05,10,03,16,10259,4348,7846,5911,1935,2413,100.0,42.38229846963642,76.47918900477629,57.61770153036358,18.861487474412712,23.520810995223705
05100317,05,10,03,17,3575,1741,2256,1834,422,1319,100.0,48.6993006993007,63.10489510489511,51.30069930069931,11.804195804195803,36.89510489510489
05200418,05,20,04,18,3824,887,3562,2937,625,262,100.0,23.19560669456067,93.14853556485355,76.80439330543933,16.344142259414227,6.851464435146444
05200419,05,20,04,19,1664,102,1643,1562,81,21,100.0,6.129807692307692,98.73798076923077,93.8701923076923,4.867788461538462,1.2620192307692308
05200420,05,20,04,20,5770,1866,4899,3904,995,871,100.0,32.33968804159446,84.9046793760832,67.66031195840554,17.24436741767764,15.09532062391681
05200421,05,20,04,21,4295,1238,3539,3057,482,756,100.0,28.824214202561116,82.39813736903376,71.17578579743889,11.222351571594878,17.601862630966238
05200422,05,20,04,22,1095,238,991,857,134,104,100.0,21.735159817351597,90.50228310502283,78.2648401826484,12.237442922374429,9.497716894977168
05200423,05,20,04,23,6583,2282,5280,4301,979,1303,100.0,34.66504633145982,80.20659273887286,65.33495366854018,14.871639070332677,19.793407261127147
05200524,05,20,05,24,3319,976,2942,2343,599,377,100.0,29.406447725218438,88.64115697499247,70.59355227478156,18.047604700210908,11.358843025007532
05200525,05,20,05,25,2414,621,2192,1793,399,222,100.0,25.724937862468934,90.80364540182269,74.27506213753107,16.528583264291633,9.1963545981773
05200526,05,20,05,26,5644,3247,3420,2397,1023,2224,100.0,57.53012048192772,60.59532246633593,42.46987951807229,18.125442948263643,39.40467753366407
05200527,05,20,05,27,11602,7294,7509,4308,3201,4093,100.0,62.86847095328392,64.72159972418548,37.13152904671608,27.590070677469402,35.27840027581451
05200528,05,20,05,28,7009,1937,6058,5072,986,951,100.0,27.63589670423741,86.4317306320445,72.36410329576259,14.067627336281923,13.568269367955486
05200629,05,20,06,29,8167,3409,6049,4758,1291,2118,100.0,41.741153422309296,74.06636463817803,58.258846577690704,15.807518060487327,25.933635361821967
05200630,05,20,06,30,9771,3731,7429,6040,1389,2342,100.0,38.1844232934193,76.03111247569338,61.8155767065807,14.21553576911268,23.968887524306624
05200631,05,20,06,31,8435,3325,6315,5110,1205,2120,100.0,39.41908713692946,74.86662714878483,60.58091286307054,14.285714285714285,25.133372851215174
05200632,05,20,06,32,3673,1726,2590,1947,643,1083,100.0,46.99156003267084,70.51456575006806,53.00843996732916,17.506125782738906,29.485434249931934
05200633,05,20,06,33,2006,558,1748,1448,300,258,100.0,27.81655034895314,87.13858424725822,72.18344965104686,14.955134596211368,12.861415752741776
05200634,05,20,06,34,4402,756,4020,3646,374,382,100.0,17.17401181281236,91.32212630622443,82.82598818718763,8.496138119036802,8.677873693775556
05300735,05,30,07,35,2912,1768,2254,1144,1110,658,100.0,60.71428571428571,77.40384615384616,39.285714285714285,38.11813186813187,22.596153846153847
05300736,05,30,07,36,3651,1973,2790,1678,1112,861,100.0,54.0399890440975,76.41741988496302,45.96001095590249,30.45740892906053,23.582580115036976
05300737,05,30,07,37,11550,5318,8896,6232,2664,2654,100.0,46.04329004329004,77.02164502164503,53.95670995670996,23.064935064935067,22.97835497835498
05300838,05,30,08,38,33,15,18,18,0,15,100.0,45.45454545454545,54.54545454545454,54.54545454545454,0.0,45.45454545454545
05300839,05,30,08,39,7595,3798,5325,3797,1528,2270,100.0,50.00658327847268,70.11191573403555,49.993416721527325,20.118499012508227,29.888084265964448
05300840,05,30,08,40,466,227,346,239,107,120,100.0,48.712446351931334,74.2489270386266,51.28755364806867,22.96137339055794,25.75107296137339
05300841,05,30,08,41,4543,2192,3284,2351,933,1259,100.0,48.25005502971605,72.2870349988994,51.749944970283956,20.537090028615452,27.712965001100592
05400942,05,40,09,42,3685,774,3356,2911,445,329,100.0,21.00407055630936,91.0719131614654,78.99592944369064,12.075983717774763,8.928086838534599
05400943,05,40,09,43,10400,2003,9760,8397,1363,640,100.0,19.259615384615383,93.84615384615384,80.74038461538461,13.105769230769232,6.153846153846154
05400944,05,40,09,44,2180,376,2031,1804,227,149,100.0,17.24770642201835,93.1651376146789,82.75229357798165,10.412844036697248,6.8348623853211015
05400945,05,40,09,45,3661,597,3428,3064,364,233,100.0,16.30701993990713,93.63561868341984,83.69298006009286,9.94263862332696,6.36438131658017
06100101,06,10,01,01,6858,1848,5921,5010,911,937,100.0,26.94663167104112,86.33712452610091,73.05336832895888,13.283756197142024,13.662875473899097
06100102,06,10,01,02,8843,3316,7072,5527,1545,1771,100.0,37.49858645256135,79.97285988917788,62.50141354743866,17.471446341739227,20.02714011082212
06100103,06,10,01,03,6168,2006,5168,4162,1006,1000,100.0,32.52269779507134,83.78728923476005,67.47730220492866,16.309987029831387,16.212710765239947
06100204,06,10,02,04,6838,2517,5558,4321,1237,1280,100.0,36.80900848201228,81.28107633811055,63.19099151798772,18.090084820122843,18.71892366188944
06100205,06,10,02,05,9869,3377,8131,6492,1639,1738,100.0,34.21825919546053,82.38929982774343,65.78174080453947,16.607559023203972,17.61070017225656
06100206,06,10,02,06,7686,2362,6432,5324,1108,1254,100.0,30.731199583658604,83.68462138953943,69.2688004163414,14.415820973198024,16.315378610460577
06100207,06,10,02,07,7876,2711,6465,5165,1300,1411,100.0,34.42102590147283,82.08481462671406,65.57897409852717,16.505840528186898,17.915185373285933
06100208,06,10,02,08,6816,2214,5673,4602,1071,1143,100.0,32.482394366197184,83.2306338028169,67.51760563380282,15.713028169014084,16.7693661971831
06100209,06,10,02,09,9241,3393,7437,5848,1589,1804,100.0,36.71680554052592,80.47830321393789,63.28319445947408,17.195108754463803,19.521696786062115
06100210,06,10,02,10,4865,1497,4067,3368,699,798,100.0,30.770811921891056,83.59712230215828,69.22918807810893,14.36793422404933,16.402877697841728
06200311,06,20,03,11,4907,1215,4338,3692,646,569,100.0,24.760546158549012,88.40432035867128,75.23945384145098,13.164866517220297,11.595679641328713
06200312,06,20,03,12,6092,2011,4933,4081,852,1159,100.0,33.01050558108996,80.97504924491136,66.98949441891004,13.985554826001312,19.02495075508864
06200313,06,20,03,13,7380,2492,6073,4888,1185,1307,100.0,33.766937669376695,82.28997289972901,66.2330623306233,16.056910569105693,17.710027100271002
06200314,06,20,03,14,7207,2234,6069,4973,1096,1138,100.0,30.997641182183987,84.2097960316359,69.00235881781602,15.207437213819897,15.790203968364091
06200315,06,20,03,15,5953,1884,5003,4069,934,950,100.0,31.647908617503777,84.04165966739458,68.35209138249621,15.68956828489837,15.958340332605408
06200316,06,20,03,16,5328,2264,4109,3064,1045,1219,100.0,42.492492492492495,77.12087087087087,57.507507507507505,19.613363363363366,22.87912912912913
06200317,06,20,03,17,6360,1366,5739,4994,745,621,100.0,21.47798742138365,90.23584905660378,78.52201257861635,11.713836477987421,9.764150943396228
06200418,06,20,04,18,3,3,0,0,0,3,100.0,100.0,0.0,0.0,0.0,100.0
06200419,06,20,04,19,4594,2368,3373,2226,1147,1221,100.0,51.54549412276883,73.42185459294733,48.45450587723117,24.96734871571615,26.578145407052677
06200420,06,20,04,20,7138,2106,5985,5032,953,1153,100.0,29.504062762678622,83.84701597086018,70.49593723732139,13.351078733538808,16.152984029139816
06200421,06,20,04,21,8309,2292,7028,6017,1011,1281,100.0,27.584546876880488,84.58298230834035,72.4154531231195,12.167529185220845,15.417017691659646
06200422,06,20,04,22,7084,1599,6158,5485,673,926,100.0,22.571993224167137,86.92828910220214,77.42800677583286,9.500282326369284,13.071710897797853
06200423,06,20,04,23,8576,2418,7431,6158,1273,1145,100.0,28.194962686567166,86.64878731343283,71.80503731343283,14.84375,13.351212686567166
06300524,06,30,05,24,5702,1445,4825,4257,568,877,100.0,25.341985268326905,84.61943177832339,74.65801473167309,9.961417046650297,15.380568221676604
06300525,06,30,05,25,5654,1445,4874,4209,665,780,100.0,25.557127697205516,86.20445702157764,74.44287230279448,11.761584718783162,13.795542978422356
06300526,06,30,05,26,3317,1062,2737,2255,482,580,100.0,32.016882725354236,82.51432016882725,67.98311727464576,14.531202894181488,17.485679831172746
06300527,06,30,05,27,8337,2422,7120,5915,1205,1217,100.0,29.051217464315698,85.40242293390908,70.9487825356843,14.453640398224781,14.597577066090919
06300528,06,30,05,28,10997,2612,9759,8385,1374,1238,100.0,23.75193234518505,88.74238428662362,76.24806765481496,12.494316631808674,11.257615713376376
06300629,06,30,06,29,7054,2006,5986,5048,938,1068,100.0,28.437765806634534,84.85965409696627,71.56223419336547,13.297419903600794,15.140345903033738
06300630,06,30,06,30,5630,2257,4205,3373,832,1425,100.0,40.08880994671403,74.68916518650089,59.91119005328597,14.777975133214921,25.31083481349911
06300631,06,30,06,31,2969,1069,2253,1900,353,716,100.0,36.005389019872005,75.88413607275177,63.99461098012799,11.88952509262378,24.11586392724823
06300632,06,30,06,32,13824,4105,11954,9719,2235,1870,100.0,29.694733796296298,86.47280092592592,70.30526620370371,16.16753472222222,13.527199074074073
06300633,06,30,06,33,11981,3140,10298,8841,1457,1683,100.0,26.208162924630667,85.95275853434605,73.79183707536934,12.160921458976713,14.04724146565395
06300634,06,30,06,34,8451,2041,7383,6410,973,1068,100.0,24.150988048751625,87.362442314519,75.84901195124837,11.513430363270619,12.637557685481008
06400735,06,40,07,35,10122,2354,8835,7768,1067,1287,100.0,23.256273463742342,87.28512151748666,76.74372653625767,10.541394981229006,12.714878482513337
06400736,06,40,07,36,5237,1151,4772,4086,686,465,100.0,21.978231812106166,91.12087072751575,78.02176818789384,13.09910253962192,8.879129272484247
06400737,06,40,07,37,11237,3396,8947,7841,1106,2290,100.0,30.221589392186527,79.62089525674112,69.77841060781347,9.842484648927648,20.37910474325888
06400838,06,40,08,38,7413,1435,6748,5978,770,665,100.0,19.35788479697828,91.0292728989613,80.64211520302172,10.387157695939566,8.970727101038715
06400839,06,40,08,39,5209,1175,4639,4034,605,570,100.0,22.557112689575735,89.05740065271645,77.44288731042427,11.614513342292186,10.942599347283547
06400840,06,40,08,40,7170,1207,6581,5963,618,589,100.0,16.834030683403068,91.78521617852162,83.16596931659693,8.619246861924685,8.214783821478381
06400841,06,40,08,41,6001,1558,5247,4443,804,754,100.0,25.962339610064987,87.43542742876187,74.03766038993501,13.397767038826863,12.564572571238127
06400842,06,40,08,42,4808,1805,4094,3003,1091,714,100.0,37.54159733777038,85.14975041597339,62.45840266222962,22.69134775374376,14.850249584026622
06400843,06,40,08,43,4797,1463,3966,3334,632,831,100.0,30.49822805920367,82.67667292057536,69.50177194079633,13.174900979779029,17.32332707942464
06400844,06,40,08,44,7234,2406,5965,4828,1137,1269,100.0,33.25960740945535,82.45783798728228,66.74039259054464,15.717445396737627,17.54216201271772
07100101,07,10,01,01,9719,4745,7034,4974,2060,2685,100.0,48.82189525671365,72.37370099804507,51.17810474328635,21.19559625475872,27.626299001954933
07100102,07,10,01,02,8477,4333,5652,4144,1508,2825,100.0,51.11478117258464,66.67453108410994,48.88521882741536,17.789312256694586,33.325468915890056
07100103,07,10,01,03,7675,4860,4924,2815,2109,2751,100.0,63.32247557003258,64.15635179153094,36.67752442996743,27.478827361563518,35.843648208469055
07100204,07,10,02,04,10410,4151,7934,6259,1675,2476,100.0,39.875120076849186,76.2151777137368,60.12487992315082,16.090297790585975,23.784822286263207
07100205,07,10,02,05,5154,3489,3199,1665,1534,1955,100.0,67.69499417927824,62.06829646876213,32.305005820721775,29.763290648040357,37.93170353123788
07100206,07,10,02,06,8304,4145,5841,4159,1682,2463,100.0,49.915703275529864,70.33959537572254,50.084296724470136,20.25529865125241,29.660404624277458
07200307,07,20,03,07,10501,3849,8437,6652,1785,2064,100.0,36.6536520331397,80.34472907342159,63.34634796686029,16.99838110656128,19.65527092657842
07200308,07,20,03,08,10436,4818,7557,5618,1939,2879,100.0,46.16711383671905,72.41280183978536,53.832886163280946,18.579915676504406,27.587198160214644
07200409,07,20,04,09,9251,3516,7280,5735,1545,1971,100.0,38.00670197816453,78.69419522213815,61.99329802183547,16.70089720030267,21.30580477786185
07200410,07,20,04,10,5619,3109,3860,2510,1350,1759,100.0,55.33012991635522,68.69549741946966,44.669870083644774,24.025627335824883,31.30450258053034
07200411,07,20,04,11,2763,1227,2066,1536,530,697,100.0,44.408251900108574,74.77379659790083,55.591748099891426,19.18204849800941,25.226203402099166
07200412,07,20,04,12,1706,1013,1061,693,368,645,100.0,59.37866354044549,62.19226260257913,40.62133645955451,21.570926143024618,37.807737397420865
07200413,07,20,04,13,7753,2742,6183,5011,1172,1570,100.0,35.36695472720237,79.74977428092352,64.63304527279763,15.116729008125887,20.250225719076486
07200414,07,20,04,14,3723,1476,2907,2247,660,816,100.0,39.64544721998388,78.08219178082192,60.354552780016114,17.7276390008058,21.91780821917808
07300515,07,30,05,15,6809,1786,5964,5023,941,845,100.0,26.229989719488913,87.58995447202233,73.77001028051109,13.819944191511235,12.410045527977678
07300516,07,30,05,16,8808,2632,7367,6176,1191,1441,100.0,29.8819255222525,83.63987284287012,70.1180744777475,13.521798365122617,16.36012715712988
07300517,07,30,05,17,9180,3040,7534,6140,1394,1646,100.0,33.11546840958606,82.06971677559913,66.88453159041394,15.185185185185185,17.930283224400874
07300618,07,30,06,18,9307,3057,7714,6250,1464,1593,100.0,32.846244762007096,82.88385086494037,67.15375523799291,15.73009562694746,17.116149135059633
07300619,07,30,06,19,12234,5560,9387,6674,2713,2847,100.0,45.447114598659475,76.72878862187346,54.552885401340525,22.17590322053294,23.271211378126534
07400720,07,40,07,20,11909,4994,9511,6915,2596,2398,100.0,41.9346712570325,79.86396842723991,58.0653287429675,21.7986396842724,20.136031572760096
07400721,07,40,07,21,5375,1738,4625,3637,988,750,100.0,32.334883720930236,86.04651162790698,67.66511627906976,18.38139534883721,13.953488372093023
07400822,07,40,08,22,2288,550,2040,1738,302,248,100.0,24.03846153846154,89.16083916083916,75.96153846153845,13.1993006993007,10.839160839160838
07400823,07,40,08,23,9702,3610,7859,6092,1767,1843,100.0,37.208822923108634,81.00391671820243,62.79117707689136,18.21273964131107,18.996083281797567
07400824,07,40,08,24,7264,2952,5614,4312,1302,1650,100.0,40.63876651982379,77.2852422907489,59.36123348017621,17.924008810572687,22.714757709251103
07400825,07,40,08,25,7361,3200,5553,4161,1392,1808,100.0,43.472354299687545,75.43811982067655,56.527645700312455,18.910474120364082,24.561880179323463
07400826,07,40,08,26,5140,1466,4445,3674,771,695,100.0,28.521400778210115,86.47859922178989,71.47859922178988,15.0,13.521400778210117
07400927,07,40,09,27,11225,5282,8195,5943,2252,3030,100.0,47.055679287305125,73.00668151447661,52.94432071269488,20.062360801781736,26.99331848552339
07400928,07,40,09,28,3897,2254,2479,1643,836,1418,100.0,57.839363613035665,63.61303566846293,42.160636386964335,21.45239928149859,36.38696433153708
07501029,07,50,10,29,8044,3413,6295,4631,1664,1749,100.0,42.42913973147688,78.2570860268523,57.57086026852313,20.686225758329186,21.742913973147687
07501030,07,50,10,30,8716,3741,6803,4975,1828,1913,100.0,42.921064708581916,78.05185865075724,57.078935291418084,20.972923359339145,21.94814134924277
07501031,07,50,10,31,9025,3109,7542,5916,1626,1483,100.0,34.448753462603875,83.56786703601108,65.55124653739612,18.01662049861496,16.43213296398892
07501032,07,50,10,32,5579,1929,4695,3650,1045,884,100.0,34.57608890482165,84.15486646352393,65.42391109517834,18.73095536834558,15.845133536476071
07501133,07,50,11,33,8012,3289,6078,4723,1355,1934,100.0,41.05092361457813,75.86120818771842,58.949076385421876,16.912131802296553,24.138791812281575
07501134,07,50,11,34,10540,3215,9051,7325,1726,1489,100.0,30.502846299810248,85.87286527514232,69.49715370018976,16.37571157495256,14.127134724857685
07501135,07,50,11,35,2225,573,1964,1652,312,261,100.0,25.75280898876405,88.26966292134831,74.24719101123596,14.02247191011236,11.730337078651685
07601236,07,60,12,36,10226,4510,7700,5716,1984,2526,100.0,44.10326618423626,75.29825933893996,55.896733815763746,19.401525523176215,24.701740661060043
07601237,07,60,12,37,4766,1287,4208,3479,729,558,100.0,27.003776751993286,88.2920688208141,72.99622324800671,15.295845572807384,11.7079311791859
07601238,07,60,12,38,2868,1164,2346,1704,642,522,100.0,40.58577405857741,81.79916317991632,59.41422594142259,22.384937238493723,18.200836820083683
07601339,07,60,13,39,5706,2408,4794,3298,1496,912,100.0,42.20119172800561,84.01682439537329,57.798808271994396,26.218016123378902,15.983175604626709
07601340,07,60,13,40,6384,2756,5236,3628,1608,1148,100.0,43.17042606516291,82.01754385964912,56.8295739348371,25.18796992481203,17.982456140350877
07601341,07,60,13,41,2247,696,1875,1551,324,372,100.0,30.97463284379172,83.44459279038719,69.02536715620828,14.419225634178906,16.555407209612817
07601442,07,60,14,42,10413,2506,9277,7907,1370,1136,100.0,24.066071257082495,89.09055987707674,75.93392874291752,13.156631134159225,10.90944012292327
07601443,07,60,14,43,10926,2661,9876,8265,1611,1050,100.0,24.354750137287205,90.38989566172432,75.64524986271279,14.744645799011533,9.610104338275672
07601544,07,60,15,44,8883,2893,7475,5990,1485,1408,100.0,32.56782618484746,84.14949904311607,67.43217381515254,16.717325227963524,15.850500956883936
07601545,07,60,15,45,8341,3390,6404,4951,1453,1937,100.0,40.64260879990409,76.77736482436158,59.35739120009591,17.419973624265676,23.222635175638413
07601546,07,60,15,46,6907,1412,6300,5495,805,607,100.0,20.443028811350803,91.21181410163602,79.5569711886492,11.654842912986824,8.78818589836398
07601547,07,60,15,47,3832,832,3363,3000,363,469,100.0,21.711899791231733,87.76096033402922,78.28810020876827,9.472860125260961,12.239039665970772
07601548,07,60,15,48,2893,547,2630,2346,284,263,100.0,18.907708261320426,90.9090909090909,81.09229173867956,9.816799170411338,9.090909090909092
08100101,08,10,01,01,4709,2692,2883,2017,866,1826,100.0,57.167126778509235,61.22318963686557,42.832873221490765,18.390316415374812,38.77681036313442
08100102,08,10,01,02,8237,4425,5262,3812,1450,2975,100.0,53.7210149326211,63.882481485977905,46.278985067378905,17.603496418599004,36.117518514022095
08100103,08,10,01,03,7350,3703,4967,3647,1320,2383,100.0,50.38095238095238,67.57823129251702,49.61904761904762,17.959183673469386,32.421768707483
08100104,08,10,01,04,6592,3822,4222,2770,1452,2370,100.0,57.97936893203883,64.04733009708737,42.02063106796117,22.026699029126213,35.95266990291262
08100105,08,10,01,05,5690,3641,3511,2049,1462,2179,100.0,63.98945518453427,61.704745166959576,36.01054481546573,25.69420035149385,38.295254833040424
08100206,08,10,02,06,9570,5666,5893,3904,1989,3677,100.0,59.205851619644726,61.5778474399164,40.794148380355274,20.78369905956113,38.422152560083596
08100207,08,10,02,07,7465,5038,4887,2427,2460,2578,100.0,67.48827863362358,65.46550569323509,32.51172136637642,32.953784326858674,34.5344943067649
08100208,08,10,02,08,12172,6826,7822,5346,2476,4350,100.0,56.07952678278016,64.2622412093329,43.92047321721984,20.34176799211305,35.73775879066711
08100209,08,10,02,09,8476,5041,5098,3435,1663,3378,100.0,59.473808400188766,60.14629542236904,40.526191599811234,19.62010382255781,39.853704577630964
08100310,08,10,03,10,7771,3979,5332,3792,1540,2439,100.0,51.203191352464295,68.61407798224167,48.79680864753571,19.81726933470596,31.385922017758332
08100311,08,10,03,11,7267,3508,4976,3759,1217,2291,100.0,48.27301499931196,68.47392321453144,51.72698500068804,16.7469382138434,31.526076785468554
08100312,08,10,03,12,11824,6135,7857,5689,2168,3967,100.0,51.8859945872801,66.44959404600812,48.11400541271989,18.33558863328823,33.55040595399188
08100313,08,10,03,13,3832,1473,2972,2359,613,860,100.0,38.43945720250522,77.55741127348644,61.560542797494776,15.996868475991649,22.44258872651357
08100314,08,10,03,14,8070,4969,4768,3101,1667,3302,100.0,61.57372986369269,59.08302354399009,38.42627013630731,20.656753407682775,40.91697645600991
08100415,08,10,04,15,6498,3470,4279,3028,1251,2219,100.0,53.40104647583872,65.85103108648815,46.59895352416128,19.252077562326868,34.14896891351185
08100416,08,10,04,16,6480,3425,4298,3055,1243,2182,100.0,52.85493827160494,66.32716049382717,47.14506172839506,19.182098765432098,33.67283950617284
08100417,08,10,04,17,9805,5421,6274,4384,1890,3531,100.0,55.288118306986235,63.987761346251915,44.711881693013765,19.275879653238142,36.012238653748085
08100418,08,10,04,18,9508,4554,6600,4954,1646,2908,100.0,47.896508203618005,69.4152292806058,52.103491796381995,17.311737484223812,30.584770719394193
08100419,08,10,04,19,7153,4395,4196,2758,1438,2957,100.0,61.44275129316371,58.66070180343912,38.5572487068363,20.103453096602824,41.33929819656088
08100520,08,10,05,20,5836,4381,3623,1455,2168,2213,100.0,75.06854009595614,62.08019191226868,24.931459904043866,37.14873200822481,37.91980808773132
08100521,08,10,05,21,9547,6350,6671,3197,3474,2876,100.0,66.51304074578401,69.87535351419294,33.48695925421599,36.388394259976955,30.124646485807062
08200622,08,20,06,22,5645,3905,3099,1740,1359,2546,100.0,69.1762621789194,54.89813994685563,30.823737821080606,24.07440212577502,45.10186005314438
08200623,08,20,06,23,6016,2779,4518,3237,1281,1498,100.0,46.19348404255319,75.0997340425532,53.80651595744681,21.293218085106382,24.900265957446805
08200624,08,20,06,24,8762,4239,6603,4523,2080,2159,100.0,48.37936544167999,75.35950696188085,51.62063455832002,23.738872403560833,24.640493038119153
08200725,08,20,07,25,2462,815,2150,1647,503,312,100.0,33.10316815597076,87.32737611697806,66.89683184402925,20.430544272948822,12.672623883021933
08200726,08,20,07,26,6172,1832,5339,4340,999,833,100.0,29.682436811406347,86.50356448476992,70.31756318859365,16.18600129617628,13.49643551523007
08200727,08,20,07,27,7921,2445,6803,5476,1327,1118,100.0,30.86731473298826,85.88562050246182,69.13268526701174,16.75293523545007,14.11437949753819
08200728,08,20,07,28,1211,409,1032,802,230,179,100.0,33.77374071015689,85.21882741535921,66.2262592898431,18.9925681255161,14.781172584640792
08200729,08,20,07,29,1854,676,1598,1178,420,256,100.0,36.461704422869474,86.19201725997843,63.53829557713053,22.653721682847898,13.807982740021574
08200730,08,20,07,30,3381,1162,2788,2219,569,593,100.0,34.368530020703936,82.46081041112096,65.63146997929607,16.829340431824903,17.53918958887903
08200831,08,20,08,31,8319,2456,7251,5863,1388,1068,100.0,29.52277918018993,87.16191849981969,70.47722081981007,16.684697680009617,12.838081500180309
08200832,08,20,08,32,11614,3842,9938,7772,2166,1676,100.0,33.08076459445497,85.56914069226795,66.91923540554502,18.64990528672292,14.430859307732046
08200833,08,20,08,33,8652,4134,6563,4518,2045,2089,100.0,47.78085991678225,75.85529357374018,52.21914008321775,23.63615349052242,24.144706426259823
08300934,08,30,09,34,12550,6736,9810,5814,3996,2740,100.0,53.67330677290837,78.16733067729083,46.32669322709163,31.840637450199203,21.832669322709165
08300935,08,30,09,35,7336,3347,5954,3989,1965,1382,100.0,45.62431842966194,81.16139585605234,54.37568157033807,26.785714285714285,18.838604143947656
08301036,08,30,10,36,7141,3511,5656,3630,2026,1485,100.0,49.166783363674554,79.2045931942305,50.83321663632544,28.371376557905055,20.795406805769503
08301037,08,30,10,37,10798,6403,8190,4395,3795,2608,100.0,59.29801815150954,75.84737914428598,40.70198184849046,35.14539729579552,24.152620855714023
08401138,08,40,11,38,2897,997,2485,1900,585,412,100.0,34.41491197790818,85.77839143942009,65.58508802209182,20.19330341732827,14.22160856057991
08401139,08,40,11,39,4106,1481,3460,2625,835,646,100.0,36.06916707257672,84.26692644909888,63.93083292742329,20.336093521675597,15.73307355090112
08401140,08,40,11,40,2665,946,2250,1719,531,415,100.0,35.497185741088174,84.42776735459663,64.50281425891183,19.924953095684803,15.572232645403378
08401241,08,40,12,41,8179,3044,6878,5135,1743,1301,100.0,37.21726372417166,84.0934099523169,62.78273627582834,21.310673676488566,15.906590047683093
08401242,08,40,12,42,6808,1831,6066,4977,1089,742,100.0,26.894829612220917,89.10105757931845,73.10517038777908,15.995887191539365,10.898942420681552
08401243,08,40,12,43,10005,3118,8572,6887,1685,1433,100.0,31.164417791104448,85.67716141929036,68.83558220889554,16.8415792103948,14.322838580709647
08401244,08,40,12,44,7145,1876,6547,5269,1278,598,100.0,26.256123163051086,91.63051084674598,73.74387683694891,17.88663400979706,8.369489153254024
08401245,08,40,12,45,3727,1158,3319,2569,750,408,100.0,31.07056613898578,89.05285752616045,68.92943386101422,20.12342366514623,10.94714247383955
08401246,08,40,12,46,7882,2217,6967,5665,1302,915,100.0,28.127378837858412,88.39127125095153,71.8726211621416,16.518650088809945,11.608728749048465
09100101,09,10,01,01,13108,4413,10511,8695,1816,2597,100.0,33.66646322856271,80.18767165090021,66.33353677143728,13.854134879462924,19.812328349099786
09100202,09,10,02,02,4310,877,3826,3433,393,484,100.0,20.348027842227378,88.77030162412993,79.65197215777262,9.118329466357308,11.22969837587007
09100203,09,10,02,03,6901,1451,5934,5450,484,967,100.0,21.02593826981597,85.98753803796552,78.97406173018403,7.013476307781481,14.012461962034486
09100304,09,10,03,04,11766,2287,10393,9479,914,1373,100.0,19.43736189019208,88.33078361380248,80.56263810980792,7.768145503994561,11.669216386197519
09100305,09,10,03,05,4022,858,3496,3164,332,526,100.0,21.332670313276978,86.92192938836399,78.66732968672302,8.254599701640974,13.078070611636003
09100306,09,10,03,06,3101,1000,2558,2101,457,543,100.0,32.24766204450177,82.48951950983555,67.75233795549823,14.737181554337312,17.51048049016446
09100407,09,10,04,07,8446,1180,7756,7266,490,690,100.0,13.971110584892257,91.83045228510538,86.02888941510774,5.801562869997632,8.169547714894625
09100408,09,10,04,08,8225,1441,7368,6784,584,857,100.0,17.519756838905774,89.580547112462,82.48024316109422,7.100303951367781,10.419452887537995
09100409,09,10,04,09,3861,952,3460,2909,551,401,100.0,24.656824656824657,89.61408961408961,75.34317534317535,14.27091427091427,10.385910385910387
09200510,09,20,05,10,7562,2636,5558,4926,632,2004,100.0,34.858503041523406,73.49907431896324,65.1414969584766,8.357577360486644,26.50092568103676
09200511,09,20,05,11,12795,3249,10600,9546,1054,2195,100.0,25.392731535756152,82.84486127393514,74.60726846424384,8.237592809691286,17.15513872606487
09200512,09,20,05,12,3766,1120,2955,2646,309,811,100.0,29.739776951672862,78.46521508231545,70.26022304832715,8.204992033988317,21.534784917684547
09200613,09,20,06,13,9999,3485,7295,6514,781,2704,100.0,34.85348534853485,72.95729572957296,65.14651465146515,7.81078107810781,27.04270427042704
09200614,09,20,06,14,3560,380,3333,3180,153,227,100.0,10.674157303370785,93.62359550561797,89.32584269662921,4.297752808988764,6.376404494382022
09200715,09,20,07,15,3068,1300,2137,1768,369,931,100.0,42.3728813559322,69.65449804432855,57.6271186440678,12.027379400260756,30.345501955671445
09200716,09,20,07,16,7699,1833,6361,5866,495,1338,100.0,23.80828679049227,82.62111962592545,76.19171320950772,6.429406416417717,17.378880374074555
09200717,09,20,07,17,9561,1982,8141,7579,562,1420,100.0,20.73004915803786,85.14799707143604,79.26995084196213,5.878046229473904,14.852002928563957
09200818,09,20,08,18,3342,488,3019,2854,165,323,100.0,14.602034709754639,90.33512866546978,85.39796529024535,4.937163375224417,9.664871334530222
09200819,09,20,08,19,8359,2002,6924,6357,567,1435,100.0,23.950233281493002,82.83287474578299,76.049766718507,6.78310802727599,17.167125254217012
09300920,09,30,09,20,12261,2363,11088,9898,1190,1173,100.0,19.272490008971534,90.43308049914363,80.72750999102847,9.705570508115162,9.566919500856375
09300921,09,30,09,21,2740,387,2554,2353,201,186,100.0,14.124087591240874,93.21167883211679,85.87591240875912,7.335766423357665,6.788321167883211
09300922,09,30,09,22,5916,1262,5108,4654,454,808,100.0,21.331981068289384,86.34212305611901,78.66801893171062,7.674104124408385,13.657876943881
09300923,09,30,09,23,8140,1832,7252,6308,944,888,100.0,22.506142506142506,89.0909090909091,77.4938574938575,11.597051597051596,10.909090909090908
09301024,09,30,10,24,2663,403,2476,2260,216,187,100.0,15.133308298911002,92.97784453623733,84.866691701089,8.11115283514833,7.022155463762673
09301025,09,30,10,25,10939,1810,9786,9129,657,1153,100.0,16.546302221409633,89.45973123685894,83.45369777859037,6.00603345826858,10.540268763141054
09301126,09,30,11,26,7480,1300,6686,6180,506,794,100.0,17.379679144385026,89.3850267379679,82.62032085561498,6.764705882352941,10.614973262032086
09301227,09,30,12,27,1883,200,1816,1683,133,67,100.0,10.621348911311737,96.44184811471057,89.37865108868827,7.063197026022305,3.5581518852894316
09301228,09,30,12,28,2652,321,2501,2331,170,151,100.0,12.104072398190045,94.30618401206637,87.89592760180996,6.41025641025641,5.693815987933635
09401329,09,40,13,29,10151,805,9719,9346,373,432,100.0,7.930253177026894,95.74426164909862,92.06974682297312,3.674514826125505,4.255738350901389
09401330,09,40,13,30,1869,208,1779,1661,118,90,100.0,11.128945960406634,95.18459069020867,88.87105403959336,6.313536650615302,4.815409309791333
09401431,09,40,14,31,5393,550,5132,4843,289,261,100.0,10.198405340255887,95.16039310216948,89.80159465974411,5.358798442425367,4.839606897830521
09401432,09,40,14,32,1567,275,1402,1292,110,165,100.0,17.549457562220805,89.47032546266752,82.45054243777919,7.019783024888322,10.529674537332482
09401433,09,40,14,33,4483,752,3951,3731,220,532,100.0,16.77448137407986,88.13294668748605,83.22551862592015,4.907428061565915,11.867053312513942
09401534,09,40,15,34,7372,1629,6281,5743,538,1091,100.0,22.097124253933803,85.20075963103635,77.90287574606619,7.297883884970158,14.799240368963645
09401635,09,40,16,35,6908,620,6657,6288,369,251,100.0,8.97510133178923,96.36653155761437,91.02489866821077,5.34163288940359,3.63346844238564
09501736,09,50,17,36,4618,584,4227,4034,193,391,100.0,12.646167171935904,91.53313122563881,87.3538328280641,4.179298397574708,8.466868774361195
09501737,09,50,17,37,14446,1381,13731,13065,666,715,100.0,9.55973972033781,95.05053301952098,90.44026027966218,4.610272739858785,4.949466980479025
09501838,09,50,18,38,10233,1213,9553,9020,533,680,100.0,11.853806312909215,93.35483240496433,88.14619368709077,5.208638717873546,6.645167595035669
09501939,09,50,19,39,6414,1194,5616,5220,396,798,100.0,18.6155285313377,87.55846585594013,81.3844714686623,6.17399438727783,12.441534144059869
09501940,09,50,19,40,2708,498,2372,2210,162,336,100.0,18.389955686853767,87.59231905465288,81.61004431314623,5.982274741506647,12.40768094534712
09501941,09,50,19,41,2755,394,2512,2361,151,243,100.0,14.301270417422868,91.17967332123412,85.69872958257714,5.480943738656988,8.82032667876588
09502042,09,50,20,42,4164,498,3856,3666,190,308,100.0,11.959654178674352,92.60326609029778,88.04034582132564,4.5629202689721415,7.396733909702209
09502043,09,50,20,43,9151,869,8666,8282,384,485,100.0,9.496229920227298,94.70003278330236,90.5037700797727,4.196262703529669,5.299967216697628
10100101,10,10,01,01,5732,1729,4691,4003,688,1041,100.0,30.163991625959525,81.83879972086532,69.83600837404047,12.002791346824843,18.161200279134682
10100102,10,10,01,02,3524,1104,2761,2420,341,763,100.0,31.32803632236095,78.34846765039728,68.67196367763904,9.67650397275823,21.65153234960272
10100103,10,10,01,03,7677,2075,6514,5602,912,1163,100.0,27.028787286700535,84.85085319786376,72.97121271329947,11.879640484564282,15.14914680213625
10100104,10,10,01,04,7577,2272,6540,5305,1235,1037,100.0,29.985482380889533,86.31384452949716,70.01451761911046,16.299326910386696,13.686155470502836
10100205,10,10,02,05,1275,867,461,408,53,814,100.0,68.0,36.15686274509804,32.0,4.156862745098039,63.84313725490196
10100206,10,10,02,06,11192,3112,9469,8080,1389,1723,100.0,27.80557541100786,84.60507505360972,72.19442458899213,12.410650464617584,15.39492494639028
10100207,10,10,02,07,8177,1488,7268,6689,579,909,100.0,18.197382903265254,88.88345358933594,81.80261709673474,7.080836492601199,11.116546410664057
10100208,10,10,02,08,9401,2504,7948,6897,1051,1453,100.0,26.6354643123072,84.54419742580576,73.3645356876928,11.179661738112967,15.455802574194236
10100209,10,10,02,09,8311,2439,6701,5872,829,1610,100.0,29.346649019371917,80.62808326314523,70.65335098062808,9.974732282517145,19.37191673685477
10100210,10,10,02,10,10756,2992,9213,7764,1449,1543,100.0,27.81703235403496,85.65451840833023,72.18296764596505,13.471550762365192,14.345481591669765
10100311,10,10,03,11,2221,659,1833,1562,271,388,100.0,29.671319225574067,82.5303917154435,70.32868077442593,12.20171094101756,17.469608284556507
10100312,10,10,03,12,15087,4356,12760,10731,2029,2327,100.0,28.872539272221115,84.57612514084974,71.12746072777888,13.448664413070855,15.42387485915026
10100313,10,10,03,13,4734,1459,3811,3275,536,923,100.0,30.81960287283481,80.50274609209971,69.18039712716518,11.322348964934516,19.497253907900298
10100314,10,10,03,14,6320,1320,5650,5000,650,670,100.0,20.88607594936709,89.39873417721519,79.11392405063292,10.284810126582279,10.601265822784809
10100315,10,10,03,15,7341,2060,6354,5281,1073,987,100.0,28.061571992916495,86.55496526358807,71.9384280070835,14.616537256504564,13.445034736411934
10100316,10,10,03,16,3708,578,3495,3130,365,213,100.0,15.587918015102481,94.25566343042071,84.41208198489751,9.843581445523194,5.744336569579287
10200417,10,20,04,17,7180,2507,5710,4673,1037,1470,100.0,34.91643454038997,79.52646239554318,65.08356545961003,14.442896935933147,20.473537604456823
10200418,10,20,04,18,5940,991,5317,4949,368,623,100.0,16.683501683501685,89.51178451178451,83.31649831649833,6.1952861952861955,10.488215488215488
10200419,10,20,04,19,3554,1488,2508,2066,442,1046,100.0,41.868317388857626,70.56837366347777,58.131682611142374,12.436691052335396,29.431626336522225
10200420,10,20,04,20,7205,2064,5601,5141,460,1604,100.0,28.64677307425399,77.73768216516308,71.353226925746,6.384455239417071,22.26231783483692
10200421,10,20,04,21,1754,914,1217,840,377,537,100.0,52.109464082098064,69.38426453819841,47.890535917901936,21.493728620296466,30.615735461801595
10200422,10,20,04,22,6622,2675,4471,3947,524,2151,100.0,40.39565086076714,67.51736635457566,59.60434913923286,7.913017215342796,32.48263364542434
10200423,10,20,04,23,5899,1941,4550,3958,592,1349,100.0,32.903882013900656,77.13171724021021,67.09611798609933,10.035599254110867,22.868282759789796
10200524,10,20,05,24,10600,2498,8847,8102,745,1753,100.0,23.566037735849058,83.4622641509434,76.43396226415095,7.028301886792453,16.537735849056602
10200525,10,20,05,25,5328,1497,4240,3831,409,1088,100.0,28.096846846846844,79.57957957957959,71.90315315315316,7.676426426426426,20.42042042042042
10200526,10,20,05,26,6054,2157,4498,3897,601,1556,100.0,35.62933597621407,74.29798480343575,64.37066402378593,9.927320779649818,25.702015196564254
10200627,10,20,06,27,3474,784,2997,2690,307,477,100.0,22.567645365572826,86.26943005181347,77.43235463442717,8.837075417386298,13.730569948186528
10200628,10,20,06,28,6479,1740,5292,4739,553,1187,100.0,26.855996295724648,81.67927149251427,73.14400370427535,8.535267788238926,18.320728507485722
10200629,10,20,06,29,8973,1656,8047,7317,730,926,100.0,18.455366098294885,89.68015156580854,81.54463390170511,8.135517664103421,10.319848434191464
10200630,10,20,06,30,6452,957,5978,5495,483,474,100.0,14.832610043397395,92.65344079355239,85.1673899566026,7.486050836949783,7.346559206447613
10300731,10,30,07,31,7712,1393,6890,6319,571,822,100.0,18.062759336099585,89.34128630705395,81.93724066390041,7.404045643153527,10.658713692946058
10300732,10,30,07,32,7052,1613,6169,5439,730,883,100.0,22.87294384571753,87.47872943845717,77.12705615428247,10.351673284174701,12.521270561542824
10300733,10,30,07,33,4729,1197,4023,3532,491,706,100.0,25.3119052653838,85.07083950095158,74.6880947346162,10.382744766335378,14.929160499048425
10300734,10,30,07,34,10361,1338,9808,9023,785,553,100.0,12.913811408165236,94.66267734774635,87.08618859183477,7.5764887559115905,5.337322652253643
10400835,10,40,08,35,7774,754,7425,7020,405,349,100.0,9.698996655518394,95.51067661435553,90.3010033444816,5.209673269873939,4.489323385644456
10400836,10,40,08,36,3871,469,3583,3402,181,288,100.0,12.115732368896925,92.56006199948334,87.88426763110307,4.675794368380264,7.439938000516662
10400837,10,40,08,37,7711,601,7522,7110,412,189,100.0,7.794060433147451,97.5489560368305,92.20593956685255,5.343016469977954,2.451043963169498
10400938,10,40,09,38,9974,907,9603,9067,536,371,100.0,9.093643473029879,96.28032885502306,90.90635652697013,5.373972328052937,3.71967114497694
10400939,10,40,09,39,4426,546,4161,3880,281,265,100.0,12.336195210122005,94.01265250790782,87.663804789878,6.348847718029823,5.987347492092183
10400940,10,40,09,40,5788,428,5602,5360,242,186,100.0,7.394609536973047,96.78645473393227,92.60539046302695,4.181064270905321,3.2135452660677264
10400941,10,40,09,41,9694,821,9391,8873,518,303,100.0,8.469156179079842,96.87435527130184,91.53084382092015,5.343511450381679,3.125644728698164
11100101,11,10,01,01,3283,288,3140,2995,145,143,100.0,8.772464209564424,95.64422784038989,91.22753579043558,4.41669204995431,4.355772159610113
11100102,11,10,01,02,2700,971,1958,1729,229,742,100.0,35.96296296296296,72.51851851851852,64.03703703703704,8.481481481481481,27.481481481481477
11100203,11,10,02,03,8955,3099,6962,5856,1106,1993,100.0,34.60636515912898,77.74427694025684,65.39363484087102,12.350642099385817,22.25572305974316
11100204,11,10,02,04,7000,2425,5444,4575,869,1556,100.0,34.64285714285714,77.77142857142857,65.35714285714286,12.414285714285715,22.228571428571428
11100205,11,10,02,05,6152,1897,4849,4255,594,1303,100.0,30.83550065019506,78.81989596879063,69.16449934980494,9.655396618985696,21.180104031209364
11100206,11,10,02,06,7571,2339,5857,5232,625,1714,100.0,30.89420155857879,77.36098269713379,69.10579844142121,8.255184255712587,22.6390173028662
11100307,11,10,03,07,11761,3770,9474,7991,1483,2287,100.0,32.05509735566704,80.55437462800782,67.94490264433296,12.609471983674858,19.44562537199218
11100308,11,10,03,08,9591,2955,7680,6636,1044,1911,100.0,30.810134501094776,80.07507037847984,69.18986549890522,10.885204879574601,19.924929621520178
11100309,11,10,03,09,6010,1460,4989,4550,439,1021,100.0,24.292845257903494,83.0116472545757,75.7071547420965,7.304492512479201,16.988352745424294
11200410,11,20,04,10,10088,3224,7711,6864,847,2377,100.0,31.958762886597935,76.43735130848532,68.04123711340206,8.396114195083266,23.56264869151467
11200411,11,20,04,11,6786,1682,5747,5104,643,1039,100.0,24.786324786324787,84.68906572354848,75.21367521367522,9.475390509873268,15.310934276451519
11200512,11,20,05,12,3887,804,3284,3083,201,603,100.0,20.68433239001801,84.4867507074865,79.31566760998199,5.171083097504503,15.513249292513507
11200513,11,20,05,13,10037,2795,7942,7242,700,2095,100.0,27.846966224967616,79.12722925176845,72.15303377503238,6.974195476736076,20.87277074823154
11200514,11,20,05,14,15627,4919,12521,10708,1813,3106,100.0,31.477570870928524,80.12414410955398,68.52242912907148,11.601714980482498,19.875855890446022
11200515,11,20,05,15,4215,1019,3652,3196,456,563,100.0,24.175563463819692,86.64294187425861,75.8244365361803,10.818505338078293,13.3570581257414
11300616,11,30,06,16,5988,2226,4649,3762,887,1339,100.0,37.17434869739479,77.63861055444222,62.82565130260521,14.812959251837007,22.361389445557784
11300617,11,30,06,17,4275,1206,3611,3069,542,664,100.0,28.210526315789476,84.46783625730994,71.78947368421052,12.678362573099417,15.532163742690058
11300618,11,30,06,18,3728,1115,2960,2613,347,768,100.0,29.9087982832618,79.39914163090128,70.0912017167382,9.30793991416309,20.600858369098713
11300619,11,30,06,19,8472,3023,6410,5449,961,2062,100.0,35.682247403210575,75.66100094428705,64.31775259678942,11.343248347497639,24.338999055712936
11300620,11,30,06,20,11227,3991,8737,7236,1501,2490,100.0,35.54823194085686,77.82132359490514,64.45176805914313,13.369555535762,22.178676405094862
11300721,11,30,07,21,5405,3423,2300,1982,318,3105,100.0,63.33024976873266,42.5531914893617,36.669750231267344,5.883441258094358,57.446808510638306
11300722,11,30,07,22,10088,2650,8578,7438,1140,1510,100.0,26.268834258524983,85.03172085646312,73.73116574147502,11.300555114988105,14.968279143536876
11300723,11,30,07,23,2358,1558,1022,800,222,1336,100.0,66.0729431721798,43.341815097540284,33.92705682782019,9.414758269720101,56.65818490245971
11300724,11,30,07,24,4039,1121,3303,2918,385,736,100.0,27.754394652141617,81.7776677395395,72.24560534785837,9.532062391681109,18.22233226046051
11300725,11,30,07,25,9958,2411,8340,7547,793,1618,100.0,24.21168909419562,83.7517573810002,75.78831090580438,7.963446475195822,16.2482426189998
11300826,11,30,08,26,9852,3832,7428,6020,1408,2424,100.0,38.895655704425494,75.3958587088916,61.1043442955745,14.291514413317094,24.604141291108405
11400927,11,40,09,27,4188,1065,3497,3123,374,691,100.0,25.429799426934096,83.50047755491882,74.5702005730659,8.930276981852913,16.499522445081187
11400928,11,40,09,28,2406,784,1864,1622,242,542,100.0,32.58520365752286,77.47298420615128,67.41479634247715,10.058187863674148,22.52701579384871
11400929,11,40,09,29,16263,4476,13044,11787,1257,3219,100.0,27.52259730676997,80.20660394761114,72.47740269323003,7.72920125438111,19.79339605238886
11400930,11,40,09,30,4687,858,4182,3829,353,505,100.0,18.30595263494773,89.22551738852145,81.69404736505227,7.531470023469169,10.774482611478557
11400931,11,40,09,31,6754,1893,5518,4861,657,1236,100.0,28.027835356825587,81.69973349126444,71.97216464317442,9.727568848090021,18.300266508735564
11401032,11,40,10,32,6011,2244,4386,3767,619,1625,100.0,37.33155880885044,72.96622858093495,62.66844119114956,10.297787389785393,27.033771419065044
11401033,11,40,10,33,6776,2596,5194,4180,1014,1582,100.0,38.311688311688314,76.65289256198346,61.68831168831169,14.964580873671782,23.34710743801653
11401034,11,40,10,34,3345,1114,2580,2231,349,765,100.0,33.303437967115094,77.13004484304933,66.6965620328849,10.433482810164424,22.869955156950674
11401135,11,40,11,35,10768,3614,8513,7154,1359,2255,100.0,33.562407132243685,79.05832095096582,66.43759286775631,12.62072808320951,20.941679049034175
11401136,11,40,11,36,8105,1982,6664,6123,541,1441,100.0,24.45404071560765,82.22085132634176,75.54595928439235,6.6748920419494135,17.779148673658234
11401137,11,40,11,37,8659,2933,6849,5726,1123,1810,100.0,33.87227162489895,79.09689340570505,66.12772837510104,12.969165030603996,20.903106594294954
11501238,11,50,12,38,4266,1034,3680,3232,448,586,100.0,24.238162212845758,86.26347866854196,75.76183778715424,10.501640881387717,13.73652133145804
11501339,11,50,13,39,10338,2440,8668,7898,770,1670,100.0,23.602244147804218,83.84600502998646,76.39775585219579,7.448249177790675,16.153994970013542
11501340,11,50,13,40,10657,1498,9889,9159,730,768,100.0,14.056488692877918,92.79346908135497,85.94351130712208,6.849957774232898,7.206530918645022
11501341,11,50,13,41,7410,1264,6669,6146,523,741,100.0,17.058029689608638,90.0,82.94197031039137,7.058029689608637,10.0
12100101,12,10,01,01,10965,6174,7249,4791,2458,3716,100.0,56.30642954856361,66.11035111719106,43.693570451436386,22.416780665754672,33.889648882808935
12100102,12,10,01,02,9859,5040,6754,4819,1935,3105,100.0,51.120803326909424,68.50593366467187,48.879196673090576,19.626736991581296,31.494066335328124
12100103,12,10,01,03,7587,3465,5584,4122,1462,2003,100.0,45.67022538552787,73.59957822591274,54.32977461447213,19.269803611440622,26.400421774087256
12100204,12,10,02,04,8822,4278,6397,4544,1853,2425,100.0,48.49240535026071,72.51190206302425,51.50759464973929,21.00430741328497,27.48809793697574
12100205,12,10,02,05,13877,6561,10079,7316,2763,3798,100.0,47.279671398717305,72.63097211212798,52.720328601282695,19.910643510845283,27.369027887872015
12100206,12,10,02,06,4613,1544,3771,3069,702,842,100.0,33.470626490353354,81.74723607197052,66.52937350964665,15.217862562323866,18.25276392802948
12200307,12,20,03,07,2714,1114,2027,1600,427,687,100.0,41.046425939572586,74.68680913780398,58.953574060427414,15.733235077376568,25.313190862196024
12200308,12,20,03,08,5644,2523,4288,3121,1167,1356,100.0,44.702338766832035,75.97448618001418,55.29766123316796,20.67682494684621,24.025513819985825
12200309,12,20,03,09,10813,5992,7000,4821,2179,3813,100.0,55.41477850735226,64.73689077961713,44.58522149264773,20.15166928696939,35.26310922038287
12200310,12,20,03,10,8211,4994,5205,3217,1988,3006,100.0,60.820850079162106,63.39057362075265,39.1791499208379,24.21142369991475,36.60942637924735
12200411,12,20,04,11,362,259,206,103,103,156,100.0,71.54696132596685,56.9060773480663,28.45303867403315,28.45303867403315,43.0939226519337
12200412,12,20,04,12,6398,2295,5130,4103,1027,1268,100.0,35.87058455767427,80.18130665833073,64.12941544232574,16.051891216005,19.81869334166927
12200413,12,20,04,13,8026,3414,6161,4612,1549,1865,100.0,42.536755544480435,76.7630201844007,57.46324445551956,19.299775728881137,23.2369798155993
12200414,12,20,04,14,1431,394,1243,1037,206,188,100.0,27.53319357092942,86.86233403214536,72.46680642907059,14.395527603074774,13.137665967854648
12200515,12,20,05,15,10973,2739,9384,8234,1150,1589,100.0,24.961268568304018,85.51900118472615,75.03873143169598,10.480269753030164,14.480998815273855
12400616,12,40,06,16,5960,879,5612,5081,531,348,100.0,14.748322147651008,94.16107382550337,85.25167785234899,8.909395973154362,5.838926174496644
12400617,12,40,06,17,6786,959,6422,5827,595,364,100.0,14.13203654582965,94.6360153256705,85.86796345417035,8.768051871500147,5.363984674329502
12400618,12,40,06,18,3762,637,3518,3125,393,244,100.0,16.932482721956408,93.51408825093036,83.0675172780436,10.446570972886763,6.485911749069643
12400619,12,40,06,19,7733,1187,7218,6546,672,515,100.0,15.349799560325877,93.34023018233545,84.65020043967412,8.690029742661322,6.659769817664555
12400720,12,40,07,20,8538,1177,8104,7361,743,434,100.0,13.785429843054581,94.91684235183884,86.21457015694543,8.702272194893418,5.083157648161162
12400721,12,40,07,21,8002,1195,7466,6807,659,536,100.0,14.933766558360409,93.30167458135466,85.0662334416396,8.235441139715071,6.6983254186453385
12400722,12,40,07,22,8519,1247,7965,7272,693,554,100.0,14.637868294400752,93.4968893062566,85.36213170559925,8.134757600657354,6.5031106937433965
12400723,12,40,07,23,8125,1368,7488,6757,731,637,100.0,16.836923076923078,92.16,83.16307692307693,8.996923076923077,7.84
12500824,12,50,08,24,9641,1647,8855,7994,861,786,100.0,17.083290115133284,91.84731874286899,82.91670988486672,8.930608858002282,8.152681257131004
12500825,12,50,08,25,6731,1936,5469,4795,674,1262,100.0,28.76244243054524,81.25092853959292,71.23755756945475,10.013370970138165,18.74907146040707
12500926,12,50,09,26,5089,1473,4264,3616,648,825,100.0,28.94478286500295,83.78856356848104,71.05521713499705,12.733346433483986,16.211436431518962
12500927,12,50,09,27,6445,1651,5652,4794,858,793,100.0,25.61675717610551,87.69588828549263,74.38324282389449,13.312645461598137,12.30411171450737
12500928,12,50,09,28,5107,1044,4636,4063,573,471,100.0,20.44252986097513,90.77736440180145,79.55747013902487,11.219894262776581,9.222635598198552
12500929,12,50,09,29,5137,907,4814,4230,584,323,100.0,17.656219583414444,93.71228343391084,82.34378041658556,11.368503017325288,6.287716566089157
12500930,12,50,09,30,10302,3868,7739,6434,1305,2563,100.0,37.54610755193166,75.12133566297805,62.45389244806834,12.667443214909726,24.878664337021938
12601031,12,60,10,31,3233,997,2779,2236,543,454,100.0,30.838230745437674,85.95731518713269,69.16176925456232,16.79554593257037,14.042684812867307
12601032,12,60,10,32,5920,3062,4006,2858,1148,1914,100.0,51.72297297297297,67.66891891891892,48.277027027027025,19.39189189189189,32.33108108108108
12601133,12,60,11,33,11412,6048,8360,5364,2996,3052,100.0,52.99684542586751,73.25622152120575,47.003154574132495,26.253066947073258,26.74377847879425
12601134,12,60,11,34,15316,7258,11654,8058,3596,3662,100.0,47.38835205014364,76.09036301906504,52.611647949856355,23.47871506920867,23.90963698093497
12601235,12,60,12,35,10598,6212,7338,4386,2952,3260,100.0,58.6148329873561,69.23947914700886,41.3851670126439,27.85431213436497,30.76052085299113
12601236,12,60,12,36,3121,1371,2524,1750,774,597,100.0,43.928228132008975,80.87151553989106,56.071771867991025,24.799743671900032,19.12848446010894
