id,district_id,forecast_area_id,district_region_id,planning_area_id,inhabitants,inhabitants_with_migration_background,inhabitants_germans,inhabitants_germans_without_migration_background,inhabitants_germans_with_migration_background,inhabitants_foreigners,inhabitants_percentage,inhabitants_with_migration_background_percentage,inhabitants_germans_percentage,inhabitants_germans_without_migration_background_percentage,inhabitants_germans_with_migration_background_percentage,inhabitants_foreigners_percentage
01011101,01,01,11,01,3126,1700,1962,1426,536,1164,100.0,54.38259756877799,62.76391554702495,45.61740243122201,17.146513115802943,37.23608445297505
01011102,01,01,11,02,199,66,142,133,9,57,100.0,33.165829145728644,71.35678391959799,66.83417085427136,4.522613065326634,28.643216080402013
01011103,01,01,11,03,5157,2838,3366,2319,1047,1791,100.0,55.03199534613147,65.27050610820244,44.968004653868526,20.302501454333914,34.72949389179756
01011104,01,01,11,04,4442,2793,2841,1649,1192,1601,100.0,62.87708239531743,63.957676722197206,37.12291760468258,26.834759117514633,36.042323277802794
01011105,01,01,11,05,1118,616,668,502,166,450,100.0,55.09838998211091,59.74955277280859,44.90161001788909,14.847942754919499,40.250447227191415
01011201,01,01,12,01,2062,1014,1416,1048,368,646,100.0,49.175557710960234,68.67119301648884,50.82444228903976,17.846750727449077,31.328806983511154
01011202,01,01,12,02,499,202,350,297,53,149,100.0,40.480961923847694,70.14028056112225,59.519038076152306,10.62124248496994,29.859719438877757
01011203,01,01,12,03,946,466,597,480,117,349,100.0,49.2600422832981,63.107822410147996,50.7399577167019,12.367864693446089,36.89217758985201
01011204,01,01,12,04,6627,2631,4919,3996,923,1708,100.0,39.701222272521505,74.22664855892562,60.298777727478495,13.927870831447112,25.773351441074393
01011301,01,01,13,01,5877,2142,4358,3735,623,1519,100.0,36.447166921898926,74.15347966649651,63.55283307810107,10.60064658839544,25.846520333503488
01011302,01,01,13,02,12316,4390,9272,7926,1346,3044,100.0,35.644689834361806,75.28418317635595,64.35531016563819,10.928873010717766,24.71581682364404
01011303,01,01,13,03,8602,3213,6339,5389,950,2263,100.0,37.351778656126484,73.69216461288073,62.64822134387352,11.043943269007208,26.307835387119276
01011304,01,01,13,04,8454,2663,6811,5791,1020,1643,100.0,31.49988171279868,80.56541282233263,68.50011828720133,12.065294535131299,19.434587177667375
01011305,01,01,13,05,7217,2195,5811,5022,789,1406,100.0,30.414299570458642,80.51822086739642,69.58570042954136,10.932520437855064,19.481779132603574
01011306,01,01,13,06,8797,3061,6823,5736,1087,1974,100.0,34.795953165852,77.5605319995453,65.204046834148,12.356485165397295,22.439468000454703
01011401,01,01,14,01,15467,5611,11421,9856,1565,4046,100.0,36.27723540440939,73.84108101118511,63.72276459559061,10.118316415594492,26.158918988814893
01011402,01,01,14,02,12893,4262,9953,8631,1322,2940,100.0,33.056697432715424,77.19692856588847,66.94330256728456,10.253625998603894,22.803071434111533
01022101,01,02,21,01,3434,1722,2235,1712,523,1199,100.0,50.14560279557367,65.08444962143273,49.85439720442633,15.230052417006407,34.91555037856727
01022102,01,02,21,02,6284,3565,3835,2719,1116,2449,100.0,56.73138128580521,61.028007638446844,43.26861871419478,17.759388924252068,38.97199236155315
01022103,01,02,21,03,263,179,130,84,46,133,100.0,68.06083650190115,49.42965779467681,31.93916349809886,17.490494296577946,50.57034220532319
01022104,01,02,21,04,17903,8277,12701,9626,3075,5202,100.0,46.23247500418925,70.9434173043624,53.76752499581075,17.175892308551642,29.0565826956376
01022105,01,02,21,05,5147,2857,3439,2290,1149,1708,100.0,55.508062949290846,66.81562074995144,44.491937050709154,22.323683699242277,33.18437925004857
01022106,01,02,21,06,11560,3832,9323,7728,1595,2237,100.0,33.148788927335644,80.64878892733563,66.85121107266437,13.79757785467128,19.35121107266436
01022201,01,02,22,01,10538,4832,7626,5706,1920,2912,100.0,45.85310305560827,72.3666729929778,54.14689694439172,18.21977604858607,27.633327007022206
01022202,01,02,22,02,1467,947,1002,520,482,465,100.0,64.5535105657805,68.30265848670757,35.446489434219494,32.85616905248807,31.697341513292432
01022203,01,02,22,03,6866,3876,4679,2990,1689,2187,100.0,56.4520827264783,68.14739295077192,43.547917273521705,24.59947567725022,31.852607049228084
01022204,01,02,22,04,5898,2207,4507,3691,816,1391,100.0,37.41946422516107,76.41573414716854,62.58053577483893,13.835198372329604,23.584265852831468
01022205,01,02,22,05,3219,1811,2289,1408,881,930,100.0,56.25970798384592,71.10904007455731,43.740292016154086,27.36874805840323,28.890959925442683
01022206,01,02,22,06,3044,1140,2434,1904,530,610,100.0,37.450722733245726,79.96057818659659,62.54927726675427,17.41130091984231,20.039421813403415
01022207,01,02,22,07,5581,2317,3966,3264,702,1615,100.0,41.5158573732306,71.06253359612973,58.4841426267694,12.578390969360328,28.93746640387028
01033101,01,03,31,01,26241,15446,16231,10795,5436,10010,100.0,58.862086048549976,61.85358789680271,41.137913951450024,20.71567394535269,38.146412103197285
01033102,01,03,31,02,11602,6811,7331,4791,2540,4271,100.0,58.70539562144458,63.1873814859507,41.29460437855542,21.892777107395275,36.8126185140493
01033201,01,03,32,01,12955,8337,9116,4618,4498,3839,100.0,64.35353145503666,70.366653801621,35.646468544963334,34.72018525665766,29.63334619837901
01033202,01,03,32,02,9720,5177,7214,4543,2671,2506,100.0,53.26131687242799,74.21810699588477,46.73868312757202,27.479423868312757,25.781893004115226
01033203,01,03,32,03,13974,8558,8757,5416,3341,5217,100.0,61.24230714183484,62.66638042078145,38.757692858165164,23.908687562616286,37.33361957921855
01044101,01,04,41,01,20069,8880,14514,11189,3325,5555,100.0,44.247346654043554,72.32049429468334,55.752653345956446,16.567840948726893,27.67950570531666
01044102,01,04,41,02,15825,5645,12460,10180,2280,3365,100.0,35.671406003159554,78.73617693522907,64.32859399684044,14.407582938388625,21.263823064770932
01044103,01,04,41,03,8094,3919,5540,4175,1365,2554,100.0,48.418581665431184,68.44576229305659,51.581418334568816,16.86434395848777,31.554237706943418
01044201,01,04,42,01,23308,15406,13489,7902,5587,9819,100.0,66.09747726102626,57.87283336193582,33.902522738973744,23.970310622962074,42.12716663806418
01044202,01,04,42,02,16628,9289,10191,7339,2852,6437,100.0,55.8636035602598,61.28818859754631,44.1363964397402,17.15179215780611,38.71181140245369
01044203,01,04,42,03,15944,8916,10067,7028,3039,5877,100.0,55.92072252885097,63.139739086803814,44.07927747114902,19.06046161565479,36.860260913196186
02010101,02,01,01,01,6140,4237,3701,1903,1798,2439,100.0,69.00651465798046,60.27687296416938,30.993485342019543,29.28338762214984,39.72312703583062
02010102,02,01,01,02,13237,8731,9168,4506,4662,4069,100.0,65.95905416635189,69.26040643650374,34.04094583364811,35.219460602855634,30.73959356349626
02010103,02,01,01,03,15588,10538,10253,5050,5203,5335,100.0,67.60328457788042,65.77495509366179,32.396715422119584,33.37823967154222,34.22504490633821
02010104,02,01,01,04,5103,3240,3471,1863,1608,1632,100.0,63.49206349206349,68.01881246325691,36.507936507936506,31.5108759553204,31.981187536743093
02020201,02,02,02,01,296,139,218,157,61,78,100.0,46.95945945945946,73.64864864864865,53.04054054054054,20.60810810810811,26.351351351351347
02020202,02,02,02,02,5844,2330,4327,3514,813,1517,100.0,39.869952087611225,74.04175222450377,60.130047912388775,13.911704312114988,25.958247775496236
02020203,02,02,02,03,10728,3870,8387,6858,1529,2341,100.0,36.07382550335571,78.17859806114839,63.92617449664429,14.252423564504102,21.821401938851604
02020204,02,02,02,04,12167,4844,9106,7323,1783,3061,100.0,39.81260787375688,74.84178515657105,60.18739212624311,14.654393030327936,25.15821484342895
02020205,02,02,02,05,14832,5646,11380,9186,2194,3452,100.0,38.066343042071196,76.72599784250271,61.933656957928804,14.792340884573893,23.274002157497304
02020206,02,02,02,06,19032,8352,13950,10680,3270,5082,100.0,43.88398486759142,73.29760403530895,56.11601513240857,17.181588902900376,26.702395964691046
02030301,02,03,03,01,9157,5679,5642,3478,2164,3515,100.0,62.018128207928356,61.61406574205526,37.98187179207164,23.63219394998362,38.38593425794474
02030302,02,03,03,02,13272,6978,8953,6294,2659,4319,100.0,52.57685352622061,67.457805907173,47.42314647377939,20.03465943339361,32.542194092827
02030401,02,03,04,01,15187,7058,10587,8129,2458,4600,100.0,46.473957990386516,69.71093698557978,53.526042009613484,16.184894975966287,30.289063014420226
02030402,02,03,04,02,11244,5458,7590,5786,1804,3654,100.0,48.541444325862685,67.50266808964781,51.458555674137315,16.044112415510494,32.49733191035219
02040501,02,04,05,01,5447,1189,4770,4258,512,677,100.0,21.82852946576097,87.57114007710666,78.17147053423903,9.399669542867633,12.428859922893336
02040502,02,04,05,02,7152,1601,6144,5551,593,1008,100.0,22.385346756152124,85.90604026845638,77.61465324384787,8.291387024608502,14.093959731543624
02040503,02,04,05,03,10726,2207,9238,8519,719,1488,100.0,20.57617005407421,86.1271676300578,79.42382994592579,6.703337684132016,13.872832369942195
02040701,02,04,07,01,12316,3952,9711,8364,1347,2605,100.0,32.08834037025008,78.84865215979214,67.91165962974992,10.936992530042222,21.15134784020786
02040702,02,04,07,02,10671,2178,9248,8493,755,1423,100.0,20.410458251335395,86.6647924280761,79.5895417486646,7.075250679411489,13.335207571923908
02040703,02,04,07,03,928,611,412,317,95,516,100.0,65.84051724137932,44.396551724137936,34.15948275862069,10.237068965517242,55.603448275862064
02050601,02,05,06,01,8785,2139,7258,6646,612,1527,100.0,24.348321001707458,82.61809903244166,75.65167899829255,6.966420034149118,17.381900967558337
02050602,02,05,06,02,20075,4814,16768,15261,1507,3307,100.0,23.980074719800747,83.52677459526775,76.01992528019925,7.506849315068494,16.473225404732254
02050801,02,05,08,01,18879,5103,15276,13776,1500,3603,100.0,27.030033370411566,80.91530271730494,72.96996662958844,7.945336087716511,19.084697282695057
02050802,02,05,08,02,19959,4987,16334,14972,1362,3625,100.0,24.986221754596922,81.8377674232176,75.01377824540307,6.82398917781452,18.162232576782404
02050803,02,05,08,03,6664,1601,5530,5063,467,1134,100.0,24.024609843937576,82.98319327731093,75.97539015606243,7.0078031212485,17.016806722689076
02050804,02,05,08,04,3567,697,3162,2870,292,405,100.0,19.54022988505747,88.64592094196804,80.45977011494253,8.18615082702551,11.35407905803196
03010101,03,01,01,01,3507,353,3289,3154,135,218,100.0,10.065583119475335,93.78386084972912,89.93441688052467,3.849443969204448,6.216139150270887
03010102,03,01,01,02,11649,1447,10594,10202,392,1055,100.0,12.42166709588806,90.94342862048245,87.57833290411195,3.365095716370504,9.056571379517555
03010104,03,01,01,04,213,39,192,174,18,21,100.0,18.30985915492958,90.14084507042254,81.69014084507043,8.450704225352112,9.859154929577464
03020203,03,02,02,03,2053,81,2023,1972,51,30,100.0,3.9454456892352656,98.53872381880176,96.05455431076474,2.484169508037019,1.4612761811982464
03020209,03,02,02,09,14143,1651,13218,12492,726,925,100.0,11.67361945838931,93.45966202361592,88.32638054161069,5.133281482005232,6.540337976384077
03020210,03,02,02,10,10503,951,10051,9552,499,452,100.0,9.054555841188233,95.69646767590211,90.94544415881177,4.751023517090355,4.303532324097876
03020307,03,02,03,07,17366,1691,16812,15675,1137,554,100.0,9.737417943107221,96.80985834389037,90.26258205689278,6.547276286997581,3.190141656109639
03030405,03,03,04,05,10610,906,10267,9704,563,343,100.0,8.539114043355326,96.76720075400566,91.46088595664467,5.30631479736098,3.2327992459943453
03030406,03,03,04,06,8147,463,7968,7684,284,179,100.0,5.683073523996563,97.80287222290414,94.31692647600343,3.4859457469006996,2.1971277770958633
03030711,03,03,07,11,6724,310,6607,6414,193,117,100.0,4.610350981558596,98.25996430696014,95.3896490184414,2.870315288518739,1.7400356930398573
03030715,03,03,07,15,6687,523,6436,6164,272,251,100.0,7.821145506206071,96.24644833258562,92.17885449379392,4.0675938387916855,3.7535516674143863
03030716,03,03,07,16,1136,34,1126,1102,24,10,100.0,2.992957746478873,99.11971830985915,97.00704225352112,2.112676056338028,0.8802816901408451
03040508,03,04,05,08,4593,844,4349,3749,600,244,100.0,18.375789244502506,94.68756803831918,81.6242107554975,13.063357282821686,5.312431961680819
03040512,03,04,05,12,9565,1054,9132,8511,621,433,100.0,11.019341348667016,95.47307893361213,88.98065865133299,6.492420282279143,4.526921066387873
03040513,03,04,05,13,3367,401,3191,2966,225,176,100.0,11.909711909711909,94.77279477279478,88.0902880902881,6.682506682506682,5.227205227205227
03040614,03,04,06,14,34543,3662,32595,30881,1714,1948,100.0,10.601279564600642,94.36065194105898,89.39872043539935,4.961931505659613,5.63934805894103
03040818,03,04,08,18,33787,4075,31135,29712,1423,2652,100.0,12.060851806907982,92.15082724124663,87.93914819309202,4.211679048154616,7.849172758753367
03050919,03,05,09,19,5555,928,4763,4627,136,792,100.0,16.705670567056703,85.74257425742574,83.29432943294329,2.4482448244824484,14.257425742574256
03050920,03,05,09,20,7168,765,6737,6403,334,431,100.0,10.672433035714286,93.98716517857143,89.32756696428571,4.659598214285714,6.012834821428571
03050923,03,05,09,23,8820,1309,7987,7511,476,833,100.0,14.841269841269842,90.55555555555556,85.15873015873015,5.396825396825397,9.444444444444445
03050924,03,05,09,24,5613,949,4967,4664,303,646,100.0,16.907179761268484,88.49100302868341,83.09282023873152,5.398182789951898,11.508996971316586
03050925,03,05,09,25,8772,1041,8145,7731,414,627,100.0,11.867305061559508,92.85225718194255,88.1326949384405,4.719562243502052,7.147742818057455
03051017,03,05,10,17,4138,653,3685,3485,200,453,100.0,15.780570323827936,89.05268245529241,84.21942967617207,4.833252779120348,10.947317544707587
03051021,03,05,10,21,6483,535,6113,5948,165,370,100.0,8.25235230603116,94.29276569489434,91.74764769396884,2.5451180009254974,5.70723430510566
03051022,03,05,10,22,4518,261,4397,4257,140,121,100.0,5.776892430278884,97.32182381584772,94.22310756972112,3.098716246126605,2.6781761841522798
03061126,03,06,11,26,14905,3363,12632,11542,1090,2273,100.0,22.56289835625629,84.75008386447502,77.43710164374372,7.312982220731298,15.249916135524991
03061131,03,06,11,31,10145,2846,8177,7299,878,1968,100.0,28.053228191227202,80.60128141941844,71.9467718087728,8.654509610645638,19.398718580581566
03061227,03,06,12,27,14376,3086,12306,11290,1016,2070,100.0,21.466332776850304,85.60100166944909,78.53366722314969,7.0673344462993875,14.398998330550919
03061228,03,06,12,28,12462,2202,10990,10260,730,1472,100.0,17.6697159364468,88.18809179906917,82.33028406355321,5.857807735515968,11.811908200930828
03061332,03,06,13,32,22176,5929,18265,16247,2018,3911,100.0,26.73611111111111,82.36381673881674,73.26388888888889,9.09992784992785,17.636183261183263
03061429,03,06,14,29,10078,1068,9442,9010,432,636,100.0,10.597340742210756,93.68922405239135,89.40265925778924,4.2865647946021035,6.310775947608653
03061430,03,06,14,30,3206,667,2695,2539,156,511,100.0,20.804741110417964,84.06113537117903,79.19525888958204,4.865876481597006,15.938864628820962
03061434,03,06,14,34,6124,1173,5330,4951,379,794,100.0,19.154147615937294,87.03461789679949,80.8458523840627,6.188765512736773,12.965382103200524
03061435,03,06,14,35,3907,859,3327,3048,279,580,100.0,21.98617865369849,85.1548502687484,78.01382134630151,7.141028922446891,14.8451497312516
03061441,03,06,14,41,2418,526,2164,1892,272,254,100.0,21.7535153019024,89.49545078577337,78.24648469809759,11.248966087675766,10.504549214226634
03071536,03,07,15,36,10594,3390,8313,7204,1109,2281,100.0,31.999244855578628,78.46894468567113,68.00075514442136,10.468189541249764,21.531055314328864
03071537,03,07,15,37,14620,4338,11567,10282,1285,3053,100.0,29.67168262653899,79.11764705882352,70.32831737346102,8.789329685362517,20.88235294117647
03071633,03,07,16,33,2709,500,2429,2209,220,280,100.0,18.456995201181247,89.66408268733849,81.54300479881876,8.12107788851975,10.335917312661499
03071638,03,07,16,38,16933,4613,13819,12320,1499,3114,100.0,27.242662257131045,81.60987421012224,72.75733774286896,8.852536467253293,18.390125789877754
03071639,03,07,16,39,12257,2764,10522,9493,1029,1735,100.0,22.55037937505099,85.8448233662397,77.449620624949,8.395202741290692,14.1551766337603
04010101,04,01,01,01,10389,4280,8073,6109,1964,2316,100.0,41.197420348445476,77.70719029742997,58.80257965155453,18.904610645875444,22.292809702570025
04010102,04,01,01,02,815,292,565,523,42,250,100.0,35.828220858895705,69.32515337423312,64.1717791411043,5.153374233128835,30.67484662576687
04010103,04,01,01,03,7638,3659,5898,3979,1919,1740,100.0,47.905210788164446,77.2191673212883,52.094789211835554,25.12437810945274,22.780832678711704
04020204,04,02,02,04,163,61,123,102,21,40,100.0,37.423312883435585,75.4601226993865,62.57668711656442,12.883435582822086,24.539877300613497
04020205,04,02,02,05,1256,264,1102,992,110,154,100.0,21.019108280254777,87.73885350318471,78.98089171974523,8.75796178343949,12.261146496815286
04020206,04,02,02,06,2541,480,2271,2061,210,270,100.0,18.890200708382526,89.37426210153482,81.10979929161746,8.264462809917356,10.625737898465172
04020207,04,02,02,07,2598,693,2208,1905,303,390,100.0,26.674364896073904,84.98845265588915,73.3256351039261,11.662817551963048,15.011547344110854
04020208,04,02,02,08,2848,691,2476,2157,319,372,100.0,24.2626404494382,86.93820224719101,75.7373595505618,11.200842696629215,13.06179775280899
04020209,04,02,02,09,3130,1106,2272,2024,248,858,100.0,35.33546325878594,72.58785942492013,64.66453674121406,7.92332268370607,27.412140575079874
04020310,04,02,03,10,602,291,350,311,39,252,100.0,48.33887043189369,58.139534883720934,51.66112956810631,6.4784053156146175,41.86046511627907
04020311,04,02,03,11,14127,3701,12026,10426,1600,2101,100.0,26.198060451617472,85.12776951936009,73.80193954838253,11.32582997097756,14.872230480639908
04020312,04,02,03,12,5357,1515,4415,3842,573,942,100.0,28.280754153444093,82.41553108082881,71.7192458465559,10.696285234272914,17.58446891917118
04020313,04,02,03,13,7339,2773,5514,4566,948,1825,100.0,37.78443929690694,75.13285188717809,62.21556070309306,12.917291184085025,24.86714811282191
04020314,04,02,03,14,8,8,0,0,0,8,100.0,100.0,0.0,0.0,0.0,100.0
04030415,04,03,04,15,2758,1347,1752,1411,341,1006,100.0,48.839738941261785,63.524292965917326,51.16026105873822,12.364031907179115,36.47570703408267
04030416,04,03,04,16,10357,4766,7673,5591,2082,2684,100.0,46.017186443950955,74.08515979530752,53.982813556049045,20.102346239258473,25.91484020469248
04030417,04,03,04,17,10797,3857,8480,6940,1540,2317,100.0,35.7228859868482,78.54033527831805,64.2771140131518,14.263221265166251,21.459664721681946
04030518,04,03,05,18,9344,3829,7047,5515,1532,2297,100.0,40.978167808219176,75.4173801369863,59.021832191780824,16.39554794520548,24.5826198630137
04030519,04,03,05,19,5624,2324,4279,3300,979,1345,100.0,41.322901849217644,76.0846372688478,58.677098150782356,17.407539118065436,23.915362731152204
04030620,04,03,06,20,8452,3515,6392,4937,1455,2060,100.0,41.587789872219595,75.62707051585423,58.412210127780405,17.21486038807383,24.372929484145764
04030621,04,03,06,21,2972,1529,2037,1443,594,935,100.0,51.44683714670256,68.53970390309556,48.553162853297444,19.986541049798117,31.46029609690444
04030622,04,03,06,22,10187,4503,7548,5684,1864,2639,100.0,44.203396485717086,74.09443408265436,55.79660351428291,18.297830568371452,25.905565917345637
04030623,04,03,06,23,4588,2439,3160,2149,1011,1428,100.0,53.16041848299913,68.87532693984308,46.83958151700087,22.035745422842197,31.124673060156933
04030724,04,03,07,24,6281,2053,5069,4228,841,1212,100.0,32.68587804489731,80.7037096003821,67.31412195510269,13.389587645279413,19.296290399617895
04030725,04,03,07,25,11845,4447,8939,7398,1541,2906,100.0,37.54326720135078,75.4664415365133,62.45673279864922,13.009708737864079,24.533558463486706
04030726,04,03,07,26,5388,2169,4061,3219,842,1327,100.0,40.25612472160356,75.37119524870081,59.743875278396445,15.627319970304379,24.62880475129918
04030827,04,03,08,27,11921,5967,8025,5954,2071,3896,100.0,50.05452562704471,67.3181780052009,49.94547437295529,17.372703632245617,32.681821994799094
04030828,04,03,08,28,9293,3862,6815,5431,1384,2478,100.0,41.5581620574626,73.33476810502529,58.44183794253739,14.892930162487893,26.66523189497471
04030929,04,03,09,29,5843,2369,4344,3474,870,1499,100.0,40.544240972103374,74.34537052883793,59.455759027896626,14.889611500941296,25.654629471162078
04030930,04,03,09,30,5449,2232,4010,3217,793,1439,100.0,40.96164433841072,73.59148467608736,59.03835566158928,14.553129014498072,26.408515323912646
04030931,04,03,09,31,3470,1790,2280,1680,600,1190,100.0,51.5850144092219,65.70605187319885,48.414985590778095,17.29106628242075,34.293948126801155
04031032,04,03,10,32,14640,5449,11453,9191,2262,3187,100.0,37.21994535519126,78.23087431693989,62.78005464480875,15.450819672131146,21.76912568306011
04041133,04,04,11,33,34,9,28,25,3,6,100.0,26.47058823529412,82.35294117647058,73.52941176470588,8.823529411764707,17.647058823529413
04041134,04,04,11,34,5008,1788,3993,3220,773,1015,100.0,35.70287539936102,79.73242811501598,64.29712460063898,15.435303514376997,20.267571884984026
04041135,04,04,11,35,2751,894,2234,1857,377,517,100.0,32.49727371864776,81.2068338785896,67.50272628135224,13.70410759723737,18.793166121410394
04041136,04,04,11,36,2960,900,2425,2060,365,535,100.0,30.405405405405407,81.92567567567568,69.5945945945946,12.33108108108108,18.074324324324326
04041137,04,04,11,37,7835,2574,6446,5261,1185,1389,100.0,32.852584556477346,82.27185705169113,67.14741544352265,15.124441608168473,17.72814294830887
04041238,04,04,12,38,5632,1629,4852,4003,849,780,100.0,28.924005681818183,86.15056818181817,71.07599431818183,15.074573863636365,13.849431818181818
04041239,04,04,12,39,202,87,142,115,27,60,100.0,43.06930693069307,70.29702970297029,56.930693069306926,13.366336633663368,29.7029702970297
04041240,04,04,12,40,1538,408,1304,1130,174,234,100.0,26.527958387516254,84.78543563068921,73.47204161248374,11.31339401820546,15.214564369310793
04041241,04,04,12,41,6933,1530,6071,5403,668,862,100.0,22.06836867157075,87.56670993797778,77.93163132842925,9.635078609548536,12.433290062022213
04041342,04,04,13,42,3964,1141,3356,2823,533,608,100.0,28.784056508577194,84.6619576185671,71.2159434914228,13.446014127144299,15.338042381432896
04041343,04,04,13,43,3519,984,2994,2535,459,525,100.0,27.96248934356351,85.08098891730606,72.03751065643648,13.043478260869565,14.919011082693947
04041344,04,04,13,44,10624,2564,9113,8060,1053,1511,100.0,24.134036144578314,85.77748493975903,75.8659638554217,9.911521084337348,14.222515060240964
04051445,04,05,14,45,6163,2477,4774,3686,1088,1389,100.0,40.191465195521666,77.46227486613662,59.80853480447834,17.653740061658283,22.53772513386338
04051446,04,05,14,46,10475,4178,8037,6297,1740,2438,100.0,39.885441527446304,76.72553699284009,60.1145584725537,16.610978520286395,23.274463007159905
04051447,04,05,14,47,5220,2002,3972,3218,754,1248,100.0,38.35249042145594,76.0919540229885,61.64750957854406,14.444444444444443,23.908045977011493
04051448,04,05,14,48,9002,3797,6602,5205,1397,2400,100.0,42.17951566318596,73.33925794267941,57.82048433681404,15.518773605865363,26.660742057320597
04051549,04,05,15,49,4251,1547,3294,2704,590,957,100.0,36.391437308868504,77.4876499647142,63.608562691131496,13.879087273582686,22.512350035285817
04051550,04,05,15,50,5356,1968,4220,3388,832,1136,100.0,36.74383868558626,78.79014189693801,63.25616131441374,15.53398058252427,21.209858103061986
04051551,04,05,15,51,4300,1604,3389,2696,693,911,100.0,37.30232558139535,78.81395348837209,62.697674418604656,16.11627906976744,21.186046511627907
04051652,04,05,16,52,9572,3355,7473,6217,1256,2099,100.0,35.05014625992478,78.07145842039282,64.94985374007521,13.121604680317592,21.928541579607188
04051653,04,05,16,53,6606,2494,5110,4112,998,1496,100.0,37.753557372085986,77.35392067817136,62.24644262791402,15.107478050257342,22.64607932182864
04051654,04,05,16,54,2968,947,2426,2021,405,542,100.0,31.90700808625337,81.73854447439352,68.09299191374663,13.645552560646902,18.26145552560647
04051655,04,05,16,55,6968,2761,5297,4207,1090,1671,100.0,39.623995407577496,76.01894374282435,60.376004592422504,15.642939150401839,23.98105625717566
04051656,04,05,16,56,7473,2147,6227,5326,901,1246,100.0,28.73009500869798,83.3266425799545,71.26990499130203,12.056737588652481,16.673357420045498
04061757,04,06,17,57,75,6,75,69,6,0,100.0,8.0,100.0,92.0,8.0,0.0
05010101,05,01,01,01,9937,2268,8916,7669,1247,1021,100.0,22.82378987622019,89.72526919593439,77.17621012377981,12.549059072154572,10.274730804065612
05010102,05,01,01,02,5700,1027,5137,4673,464,563,100.0,18.017543859649123,90.12280701754386,81.98245614035088,8.140350877192983,9.87719298245614
05010103,05,01,01,03,7397,1031,6968,6366,602,429,100.0,13.938083006624307,94.20035149384886,86.0619169933757,8.138434500473164,5.799648506151142
05010204,05,01,02,04,3100,1078,2627,2022,605,473,100.0,34.774193548387096,84.74193548387096,65.2258064516129,19.516129032258064,15.258064516129032
05010205,05,01,02,05,1915,465,1745,1450,295,170,100.0,24.281984334203656,91.12271540469973,75.71801566579634,15.404699738903393,8.87728459530026
05010206,05,01,02,06,9967,2935,8843,7032,1811,1124,100.0,29.447175679743154,88.72278519113073,70.55282432025685,18.169960870873883,11.277214808869267
05010207,05,01,02,07,11197,5061,9335,6136,3199,1862,100.0,45.19960703759936,83.37054568187907,54.80039296240064,28.570152719478433,16.629454318120924
05010208,05,01,02,08,7433,2068,6313,5365,948,1120,100.0,27.821875420422444,84.93205973362035,72.17812457957756,12.75393515404278,15.06794026637966
05010209,05,01,02,09,6037,1595,5387,4442,945,650,100.0,26.4204074871625,89.23306277952625,73.5795925128375,15.653470266688752,10.766937220473745
05010310,05,01,03,10,3788,1047,3207,2741,466,581,100.0,27.639915522703273,84.66209081309398,72.36008447729672,12.302006335797254,15.337909186906018
05010311,05,01,03,11,5535,2774,4100,2761,1339,1435,100.0,50.11743450767842,74.07407407407408,49.88256549232159,24.191508581752487,25.925925925925924
05010312,05,01,03,12,6865,3314,4692,3551,1141,2173,100.0,48.273852876911874,68.34668608885653,51.726147123088126,16.620538965768393,31.65331391114348
05010313,05,01,03,13,6504,2341,5176,4163,1013,1328,100.0,35.993234932349324,79.58179581795818,64.00676506765068,15.575030750307503,20.418204182041823
05010314,05,01,03,14,11756,3916,9690,7840,1850,2066,100.0,33.310649880911875,82.42599523647499,66.68935011908812,15.736645117386866,17.574004763525007
05010339,05,01,03,39,440,82,398,358,40,42,100.0,18.636363636363637,90.45454545454545,81.36363636363636,9.090909090909092,9.545454545454547
05020415,05,02,04,15,3895,668,3716,3227,489,179,100.0,17.150192554557126,95.40436456996149,82.84980744544288,12.554557124518615,4.595635430038511
05020416,05,02,04,16,1723,89,1695,1634,61,28,100.0,5.165409170052235,98.3749274521184,94.83459082994776,3.5403366221706327,1.625072547881602
05020417,05,02,04,17,5749,1401,5147,4348,799,602,100.0,24.36945555748826,89.52861367194295,75.63054444251173,13.898069229431206,10.471386328057052
05020418,05,02,04,18,3978,681,3686,3297,389,292,100.0,17.11915535444947,92.6596279537456,82.88084464555054,9.778783308195074,7.3403720462544
05020419,05,02,04,19,6891,1527,6187,5364,823,704,100.0,22.15933826730518,89.78377593963141,77.84066173269481,11.943114206936583,10.216224060368596
05020420,05,02,04,20,950,155,885,795,90,65,100.0,16.315789473684212,93.15789473684211,83.6842105263158,9.473684210526317,6.842105263157896
05020521,05,02,05,21,2957,681,2731,2276,455,226,100.0,23.03009807237065,92.35711870138654,76.96990192762937,15.387216773757187,7.642881298613459
05020522,05,02,05,22,7196,2745,5651,4451,1200,1545,100.0,38.1461923290717,78.52973874374652,61.8538076709283,16.67593107281823,21.470261256253472
05020523,05,02,05,23,11497,5567,9390,5930,3460,2107,100.0,48.421327302774635,81.67348003827085,51.57867269722536,30.094807341045488,18.326519961729147
05020524,05,02,05,24,6116,892,5775,5224,551,341,100.0,14.58469587965991,94.42446043165468,85.4153041203401,9.009156311314586,5.575539568345324
05020625,05,02,06,25,7379,2158,6274,5221,1053,1105,100.0,29.245155170077247,85.02507114785202,70.75484482992276,14.270226317929257,14.974928852147986
05020626,05,02,06,26,17328,4738,14739,12590,2149,2589,100.0,27.343028624192062,85.05886426592798,72.65697137580794,12.401892890120036,14.941135734072022
05020627,05,02,06,27,3936,1305,3311,2631,680,625,100.0,33.15548780487805,84.1209349593496,66.84451219512195,17.276422764227643,15.879065040650406
05020628,05,02,06,28,1988,394,1816,1594,222,172,100.0,19.81891348088531,91.34808853118712,80.18108651911469,11.167002012072434,8.651911468812877
05020629,05,02,06,29,4390,574,4128,3816,312,262,100.0,13.075170842824601,94.03189066059225,86.9248291571754,7.1070615034168565,5.968109339407745
05030730,05,03,07,30,3831,1939,3231,1892,1339,600,100.0,50.61341686243801,84.33829287392327,49.386583137562,34.951709736361266,15.661707126076744
05030731,05,03,07,31,11555,4429,9583,7126,2457,1972,100.0,38.32972739073994,82.9337948939853,61.67027260926006,21.263522284725227,17.066205106014714
05030832,05,03,08,32,11281,4438,8860,6843,2017,2421,100.0,39.34048399964542,78.53913660136513,60.65951600035457,17.879620601010547,21.46086339863487
05030833,05,03,08,33,1400,1097,399,303,96,1001,100.0,78.35714285714286,28.499999999999996,21.642857142857146,6.857142857142858,71.5
05040934,05,04,09,34,3966,1163,3108,2803,305,858,100.0,29.324256177508822,78.36611195158851,70.67574382249117,7.690368129097328,21.6338880484115
05040935,05,04,09,35,410,84,360,326,34,50,100.0,20.48780487804878,87.8048780487805,79.51219512195122,8.292682926829269,12.195121951219512
05040936,05,04,09,36,9435,1354,9021,8081,940,414,100.0,14.35082140964494,95.61208267090619,85.64917859035506,9.962904080551139,4.3879173290938
05040937,05,04,09,37,2141,268,2046,1873,173,95,100.0,12.517515179822514,95.56282111163009,87.48248482017749,8.080336291452591,4.437178888369921
05040938,05,04,09,38,3557,352,3424,3205,219,133,100.0,9.895979758223222,96.26089401180771,90.10402024177678,6.156873770030924,3.739105988192297
06010101,06,01,01,01,6768,1418,6021,5350,671,747,100.0,20.951536643026007,88.9627659574468,79.048463356974,9.914302600472812,11.037234042553191
06010102,06,01,01,02,8648,2813,7082,5835,1247,1566,100.0,32.527752081406106,81.8917668825162,67.4722479185939,14.419518963922295,18.10823311748381
06010103,06,01,01,03,6252,1786,5362,4466,896,890,100.0,28.56685860524632,85.76455534229048,71.43314139475368,14.33141394753679,14.235444657709534
06010204,06,01,02,04,6808,2032,5864,4776,1088,944,100.0,29.847238542890718,86.13396004700353,70.15276145710928,15.981198589894241,13.866039952996475
06010205,06,01,02,05,9469,2595,8240,6874,1366,1229,100.0,27.405217023972966,87.02080473122822,72.59478297602703,14.426021755201182,12.979195268771782
06010206,06,01,02,06,7606,1864,6603,5742,861,1003,100.0,24.506968183013413,86.81304233499868,75.49303181698659,11.320010518012095,13.186957665001314
06010207,06,01,02,07,7723,2203,6602,5520,1082,1121,100.0,28.52518451378998,85.48491518839829,71.47481548621002,14.010099702188269,14.515084811601708
06010208,06,01,02,08,6398,1694,5539,4704,835,859,100.0,26.477024070021884,86.57392935292279,73.52297592997812,13.05095342294467,13.426070647077212
06010209,06,01,02,09,8958,2541,7614,6417,1197,1344,100.0,28.36570663094441,84.99665103817816,71.63429336905558,13.36235766912257,15.003348961821835
06010210,06,01,02,10,4833,1207,4223,3626,597,610,100.0,24.974136147320504,87.37843989240636,75.02586385267949,12.352576039726877,12.621560107593627
06020301,06,02,03,01,4952,949,4531,4003,528,421,100.0,19.163974151857836,91.4983844911147,80.83602584814217,10.662358642972535,8.5016155088853
06020302,06,02,03,02,5369,1042,4838,4327,511,531,100.0,19.407710933134663,90.10989010989012,80.59228906686535,9.517601043024772,9.89010989010989
06020303,06,02,03,03,7257,1860,6318,5397,921,939,100.0,25.630425795783378,87.06076891277388,74.36957420421662,12.691194708557255,12.939231087226128
06020304,06,02,03,04,6864,1625,6037,5239,798,827,100.0,23.674242424242426,87.95163170163171,76.32575757575758,11.625874125874127,12.048368298368297
06020305,06,02,03,05,11134,3346,9372,7788,1584,1762,100.0,30.052092689060533,84.17460032333393,69.94790731093946,14.226693012394467,15.825399676666068
06020306,06,02,03,06,6379,1062,5936,5317,619,443,100.0,16.648377488634583,93.05533782724565,83.35162251136542,9.703715315880231,6.94466217275435
06020407,06,02,04,07,4716,2228,3626,2488,1138,1090,100.0,47.24342663273961,76.8871925360475,52.756573367260394,24.130619168787106,23.112807463952503
06020408,06,02,04,08,6543,1332,5926,5211,715,617,100.0,20.357634112792297,90.57007488919456,79.6423658872077,10.927709001986855,9.429925110805442
06020409,06,02,04,09,8117,1745,7177,6372,805,940,100.0,21.498090427497843,88.41936676111864,78.50190957250216,9.917457188616483,11.58063323888136
06020410,06,02,04,10,6914,1077,6304,5837,467,610,100.0,15.57708996239514,91.1773213769164,84.42291003760486,6.754411339311542,8.822678623083599
06020411,06,02,04,11,8377,1649,7698,6728,970,679,100.0,19.684851378775218,91.89447296168079,80.31514862122478,11.579324340456012,8.105527038319208
06030501,06,03,05,01,5479,881,5041,4598,443,438,100.0,16.079576565066617,92.00584048183975,83.92042343493338,8.08541704690637,7.994159518160249
06030502,06,03,05,02,5437,1017,4988,4420,568,449,100.0,18.705168291337134,91.7417693581019,81.29483170866287,10.446937649439029,8.258230641898106
06030503,06,03,05,03,11156,2614,9859,8542,1317,1297,100.0,23.431337396916458,88.37396916457512,76.56866260308354,11.805306561491575,11.626030835424883
06030504,06,03,05,04,10934,2033,9930,8901,1029,1004,100.0,18.593378452533383,90.8176330711542,81.40662154746661,9.41101152368758,9.182366928845802
06030605,06,03,06,05,6869,1637,5972,5232,740,897,100.0,23.83170767215024,86.94133061581016,76.16829232784977,10.773038287960402,13.05866938418984
06030606,06,03,06,06,5204,1512,4350,3692,658,854,100.0,29.054573405073018,83.58954650269024,70.94542659492697,12.64411990776326,16.410453497309764
06030607,06,03,06,07,3166,1122,2360,2044,316,806,100.0,35.43903979785218,74.54200884396715,64.56096020214783,9.98104864181933,25.45799115603285
06030608,06,03,06,08,12036,2722,10765,9314,1451,1271,100.0,22.615486872715188,89.44001329345296,77.38451312728482,12.055500166168162,10.559986706547026
06030609,06,03,06,09,11741,2399,10469,9342,1127,1272,100.0,20.432671833744998,89.1661698322119,79.56732816625501,9.598841665956904,10.833830167788093
06030610,06,03,06,10,8148,1624,7223,6524,699,925,100.0,19.93127147766323,88.6475208640157,80.06872852233677,8.57879234167894,11.352479135984291
06040701,06,04,07,01,9719,1647,8875,8072,803,844,100.0,16.94618787941146,91.31597901018623,83.05381212058853,8.262166889597696,8.684020989813765
06040702,06,04,07,02,5328,981,4928,4347,581,400,100.0,18.41216216216216,92.49249249249249,81.58783783783784,10.904654654654655,7.5075075075075075
06040703,06,04,07,03,10536,2324,9012,8212,800,1524,100.0,22.05770690964313,85.53530751708428,77.94229309035687,7.593014426727411,14.464692482915718
06040804,06,04,08,04,7431,1099,6858,6332,526,573,100.0,14.78939577445835,92.28905934598305,85.21060422554166,7.078455120441395,7.710940654016955
06040805,06,04,08,05,5305,999,4817,4306,511,488,100.0,18.83129123468426,90.80113100848256,81.16870876531574,9.632422243166824,9.198868991517436
06040806,06,04,08,06,7172,962,6705,6210,495,467,100.0,13.413273842721695,93.48856664807586,86.5867261572783,6.901840490797547,6.51143335192415
06040807,06,04,08,07,5675,1133,5063,4542,521,612,100.0,19.964757709251103,89.21585903083701,80.0352422907489,9.180616740088105,10.784140969162996
06040808,06,04,08,08,4157,1480,3573,2677,896,584,100.0,35.60259802742362,85.95140726485447,64.39740197257638,21.554005292278084,14.048592735145537
06040809,06,04,08,09,4871,1308,4056,3563,493,815,100.0,26.85280229932252,83.26832272633956,73.14719770067748,10.121125025662081,16.731677273660438
06040810,06,04,08,10,6972,1933,5844,5039,805,1128,100.0,27.725186460126217,83.8209982788296,72.27481353987379,11.546184738955825,16.179001721170398
07010101,07,01,01,01,9449,4102,7019,5347,1672,2430,100.0,43.41200126997566,74.28299290930256,56.58799873002434,17.694994179278233,25.71700709069743
07010102,07,01,01,02,15528,8062,10649,7466,3183,4879,100.0,51.91911385883565,68.57934054611026,48.08088614116435,20.498454404945903,31.420659453889748
07010103,07,01,01,03,9987,3515,7882,6472,1410,2105,100.0,35.19575448082507,78.92259937919295,64.80424551917493,14.118353860018024,21.077400620807047
07010104,07,01,01,04,13579,7666,8816,5913,2903,4763,100.0,56.454819942558366,64.92377936519625,43.54518005744164,21.37859930775462,35.07622063480374
07020201,07,02,02,01,10375,3285,8588,7090,1498,1787,100.0,31.662650602409638,82.77590361445783,68.33734939759036,14.43855421686747,17.22409638554217
07020202,07,02,02,02,9917,3841,7672,6076,1596,2245,100.0,38.731471211051726,77.36210547544621,61.268528788948274,16.093576686497933,22.637894524553797
07020203,07,02,02,03,17634,7316,13262,10318,2944,4372,100.0,41.48803447884768,75.2069865033458,58.51196552115232,16.69502098219349,24.79301349665419
07020204,07,02,02,04,11490,3921,9161,7569,1592,2329,100.0,34.12532637075718,79.73020017406441,65.87467362924282,13.855526544821583,20.269799825935596
07030301,07,03,03,01,23974,5670,20957,18304,2653,3017,100.0,23.650621506632184,87.41553349461917,76.34937849336781,11.066155001251357,12.584466505380828
07030302,07,03,03,02,9206,2591,7858,6615,1243,1348,100.0,28.144688246795567,85.35737562459266,71.85531175320443,13.502063871388225,14.642624375407342
07030303,07,03,03,03,12109,4899,9651,7210,2441,2458,100.0,40.45751094227435,79.70104880667273,59.54248905772565,20.158559748947063,20.298951193327277
07040401,07,04,04,01,17183,5895,14333,11288,3045,2850,100.0,34.30716405749869,83.41383925973346,65.6928359425013,17.72100331723215,16.586160740266543
07040402,07,04,04,02,2084,366,1932,1718,214,152,100.0,17.562380038387715,92.7063339731286,82.43761996161228,10.268714011516316,7.293666026871401
07040403,07,04,04,03,23591,7836,19446,15755,3691,4145,100.0,33.216056970878725,82.42974015514392,66.78394302912128,15.645797126022638,17.57025984485609
07040404,07,04,04,04,5038,1137,4495,3901,594,543,100.0,22.568479555379117,89.22191345772131,77.43152044462089,11.790393013100436,10.778086542278682
07040405,07,04,04,05,10778,4158,8490,6620,1870,2288,100.0,38.57858600853591,78.77157172017071,61.42141399146409,17.350157728706623,21.22842827982928
07040406,07,04,04,06,3673,1709,2674,1964,710,999,100.0,46.5287231146202,72.80152463925947,53.4712768853798,19.33024775387966,27.198475360740538
07050501,07,05,05,01,15910,5556,13168,10354,2814,2742,100.0,34.92143306096794,82.76555625392835,65.07856693903206,17.68698931489629,17.234443746071655
07050502,07,05,05,02,7779,2450,6450,5329,1121,1329,100.0,31.495050777734928,82.9155418434246,68.50494922226508,14.410592621159532,17.084458156575398
07050503,07,05,05,03,9055,2508,7878,6547,1331,1177,100.0,27.69740474875759,87.00165654334621,72.30259525124241,14.69906129210381,12.998343456653782
07050504,07,05,05,04,5544,1595,4871,3949,922,673,100.0,28.76984126984127,87.86075036075036,71.23015873015873,16.63059163059163,12.13924963924964
07050505,07,05,05,05,10448,2513,9421,7935,1486,1027,100.0,24.052450229709034,90.17036753445635,75.94754977029096,14.222817764165391,9.829632465543645
07050506,07,05,05,06,2227,464,2040,1763,277,187,100.0,20.835204310731925,91.6030534351145,79.16479568926808,12.43825774584643,8.396946564885496
07060601,07,06,06,01,9872,3675,7967,6197,1770,1905,100.0,37.226499189627226,80.70299837925445,62.773500810372774,17.929497568881686,19.297001620745544
07060602,07,06,06,02,4622,891,4255,3731,524,367,100.0,19.27736910428386,92.05971440934661,80.72263089571614,11.337083513630462,7.940285590653397
07060603,07,06,06,03,2784,891,2423,1893,530,361,100.0,32.00431034482759,87.0330459770115,67.99568965517241,19.03735632183908,12.966954022988505
07060604,07,06,06,04,14087,4658,12464,9429,3035,1623,100.0,33.065947327323066,88.47873926315042,66.93405267267694,21.544686590473486,11.521260736849577
07070701,07,07,07,01,10343,1790,9599,8553,1046,744,100.0,17.30639079570724,92.80672918882335,82.69360920429276,10.1131199845306,7.1932708111766415
07070702,07,07,07,02,10216,1705,9603,8511,1092,613,100.0,16.68950665622553,93.99960845732184,83.31049334377447,10.689115113547377,6.000391542678152
07070703,07,07,07,03,7388,1539,6772,5849,923,616,100.0,20.83107742284786,91.66215484569572,79.16892257715213,12.493232268543585,8.337845154304278
07070704,07,07,07,04,8221,2588,7139,5633,1506,1082,100.0,31.48035518793334,86.83858411385476,68.51964481206666,18.318939301788102,13.161415886145239
07070705,07,07,07,05,7033,1027,6602,6006,596,431,100.0,14.602587800369685,93.87174747618371,85.39741219963032,8.47433527655339,6.128252523816294
07070706,07,07,07,06,3825,636,3420,3189,231,405,100.0,16.627450980392155,89.41176470588236,83.37254901960785,6.03921568627451,10.588235294117647
07070707,07,07,07,07,2817,345,2640,2472,168,177,100.0,12.247071352502664,93.71671991480298,87.75292864749734,5.963791267305645,6.283280085197019
08010115,08,01,01,15,862,343,650,519,131,212,100.0,39.791183294663576,75.4060324825986,60.20881670533643,15.19721577726218,24.593967517401392
08010116,08,01,01,16,3568,1912,2345,1656,689,1223,100.0,53.58744394618834,65.72309417040358,46.41255605381166,19.31053811659193,34.27690582959641
08010117,08,01,01,17,16187,7905,10784,8282,2502,5403,100.0,48.83548526595416,66.62136282201767,51.16451473404584,15.456848087971832,33.37863717798233
08010118,08,01,01,18,11928,7043,7530,4885,2645,4398,100.0,59.04594232059021,63.12877263581489,40.95405767940979,22.174714956405097,36.87122736418511
08010211,08,01,02,11,10178,5881,6123,4297,1826,4055,100.0,57.7814894871291,60.159166830418556,42.2185105128709,17.940656317547653,39.84083316958145
08010212,08,01,02,12,7484,4911,4947,2573,2374,2537,100.0,65.61998931052912,66.10101549973277,34.38001068947087,31.721004810261892,33.89898450026724
08010213,08,01,02,13,12798,6801,8278,5997,2281,4520,100.0,53.14111579934365,64.68198155961869,46.858884200656355,17.823097358962336,35.31801844038131
08010214,08,01,02,14,8178,4566,5289,3612,1677,2889,100.0,55.83272193690389,64.67351430667645,44.16727806309611,20.506236243580336,35.32648569332355
08010301,08,01,03,01,27993,13019,19550,14974,4576,8443,100.0,46.508055585324904,69.83888829350194,53.491944414675096,16.34694387882685,30.16111170649805
08010302,08,01,03,02,3740,1260,2992,2480,512,748,100.0,33.68983957219251,80.0,66.31016042780749,13.689839572192513,20.0
08010303,08,01,03,03,8612,5095,5154,3517,1637,3458,100.0,59.16163492800743,59.8467254993033,40.83836507199257,19.00836042731073,40.1532745006967
08010404,08,01,04,04,23462,12037,15543,11425,4118,7919,100.0,51.30423663796778,66.24754922853977,48.695763362032224,17.551785866507544,33.75245077146023
08010405,08,01,04,05,9026,4071,6298,4955,1343,2728,100.0,45.10303567471748,69.7762020828717,54.89696432528252,14.879237757589186,30.223797917128298
08010406,08,01,04,06,7119,3905,4619,3214,1405,2500,100.0,54.85320972046635,64.8827082455401,45.14679027953365,19.73591796600646,35.11729175445989
08010407,08,01,04,07,805,328,582,477,105,223,100.0,40.745341614906835,72.29813664596273,59.25465838509317,13.043478260869565,27.701863354037265
08010508,08,01,05,08,5526,3764,3685,1762,1923,1841,100.0,68.11436844010133,66.6847629388346,31.88563155989866,34.79913137893594,33.3152370611654
08010509,08,01,05,09,9555,6152,6674,3403,3271,2881,100.0,64.38513867085295,69.84824699110413,35.61486132914705,34.23338566195709,30.151753008895867
08010510,08,01,05,10,371,219,219,152,67,152,100.0,59.02964959568733,59.02964959568733,40.97035040431267,18.059299191374663,40.97035040431267
08020619,08,02,06,19,10790,5423,7662,5367,2295,3128,100.0,50.25949953660797,71.01019462465246,49.74050046339203,21.26969416126043,28.989805375347544
08020620,08,02,06,20,9272,3695,7444,5577,1867,1828,100.0,39.851164797238994,80.28472821397756,60.148835202761,20.135893011216567,19.715271786022434
08020621,08,02,06,21,2271,511,2110,1760,350,161,100.0,22.501100836635842,92.91061206516953,77.49889916336416,15.411712901805371,7.089387934830471
08020622,08,02,06,22,14274,3483,12639,10791,1848,1635,100.0,24.401008827238336,88.54560739806642,75.59899117276167,12.94661622530475,11.454392601933586
08020623,08,02,06,23,1259,325,1112,934,178,147,100.0,25.814138204924543,88.32406671961874,74.18586179507545,14.138204924543288,11.675933280381255
08020624,08,02,06,24,1152,299,1021,853,168,131,100.0,25.95486111111111,88.62847222222221,74.04513888888889,14.583333333333334,11.371527777777777
08020625,08,02,06,25,3307,831,2885,2476,409,422,100.0,25.12851527063804,87.2391895978228,74.87148472936195,12.36770486846084,12.7608104021772
08020726,08,02,07,26,8270,1751,7533,6519,1014,737,100.0,21.172914147521162,91.0882708585248,78.82708585247885,12.261185006045949,8.911729141475213
08020727,08,02,07,27,11450,2563,10473,8887,1586,977,100.0,22.38427947598253,91.46724890829694,77.61572052401746,13.851528384279476,8.532751091703057
08020728,08,02,07,28,8285,2820,6941,5465,1476,1344,100.0,34.03741701870851,83.77791188895594,65.96258298129149,17.815328907664455,16.222088111044055
08030829,08,03,08,29,12300,5678,10022,6622,3400,2278,100.0,46.16260162601626,81.47967479674797,53.83739837398374,27.64227642276423,18.520325203252032
08030830,08,03,08,30,7251,2581,6233,4670,1563,1018,100.0,35.59509033236795,85.96055716452902,64.40490966763205,21.55564749689698,14.03944283547097
08030831,08,03,08,31,16904,7747,13880,9157,4723,3024,100.0,45.829389493610975,82.11074301940369,54.17061050638902,27.94013251301467,17.889256980596308
08040932,08,04,09,32,2768,731,2506,2037,469,262,100.0,26.40895953757225,90.53468208092485,73.59104046242774,16.94364161849711,9.465317919075144
08040933,08,04,09,33,3922,1106,3457,2816,641,465,100.0,28.199898011218767,88.14380418154003,71.80010198878122,16.343702192758798,11.85619581845997
08040934,08,04,09,34,2701,738,2412,1963,449,289,100.0,27.323213624583488,89.30025916327287,72.67678637541651,16.62347278785635,10.699740836727138
08041035,08,04,10,35,7875,1982,7099,5893,1206,776,100.0,25.168253968253968,90.14603174603174,74.83174603174602,15.314285714285713,9.853968253968254
08041036,08,04,10,36,6805,1316,6268,5489,779,537,100.0,19.338721528288026,92.10874357090375,80.66127847171197,11.44746509919177,7.891256429096252
08041037,08,04,10,37,9609,1926,8757,7683,1074,852,100.0,20.043709022791134,91.13331251951296,79.95629097720887,11.17702154230409,8.866687480487045
08041038,08,04,10,38,6802,1318,6377,5484,893,425,100.0,19.376653925316084,93.75183769479565,80.62334607468392,13.128491620111731,6.248162305204351
08041039,08,04,10,39,3738,1058,3394,2680,714,344,100.0,28.303905831995717,90.79721776350989,71.69609416800428,19.101123595505616,9.202782236490101
08041040,08,04,10,40,7952,1592,7396,6360,1036,556,100.0,20.02012072434608,93.00804828973843,79.97987927565391,13.028169014084506,6.99195171026157
09010101,09,01,01,01,11431,2912,9702,8519,1183,1729,100.0,25.474586650336807,84.87446417636252,74.5254133496632,10.349050826699328,15.125535823637476
09010102,09,01,01,02,69,9,60,60,0,9,100.0,13.043478260869565,86.95652173913044,86.95652173913044,0.0,13.043478260869565
09010201,09,01,02,01,4270,570,3995,3700,295,275,100.0,13.348946135831383,93.55971896955504,86.65105386416862,6.908665105386416,6.440281030444965
09010202,09,01,02,02,6712,621,6344,6091,253,368,100.0,9.252085816448153,94.51728247914184,90.74791418355184,3.769368295589988,5.482717520858165
09010301,09,01,03,01,14869,1554,13987,13315,672,882,100.0,10.451274463649202,94.06819557468559,89.54872553635079,4.5194700383347906,5.931804425314413
09010302,09,01,03,02,2941,553,2692,2388,304,249,100.0,18.80312818769126,91.53349200952057,81.19687181230873,10.336620197211833,8.466507990479428
09010401,09,01,04,01,7908,409,7694,7499,195,214,100.0,5.171977744056652,97.29387961557916,94.82802225594334,2.465857359635812,2.7061203844208395
09010402,09,01,04,02,10772,1140,10241,9632,609,531,100.0,10.58299294467137,95.07055328629781,89.41700705532864,5.653546230969179,4.929446713702191
09020501,09,02,05,01,6212,1176,5348,5036,312,864,100.0,18.931101094655507,86.09143593045718,81.0688989053445,5.022537025112685,13.90856406954282
09020502,09,02,05,02,14433,1957,13243,12476,767,1190,100.0,13.559204600568142,91.7550058892815,86.44079539943186,5.31421048984965,8.244994110718492
09020601,09,02,06,01,7202,1090,6462,6112,350,740,100.0,15.134684809775061,89.72507636767565,84.86531519022493,4.859761177450708,10.274923632324354
09020602,09,02,06,02,3504,156,3425,3348,77,79,100.0,4.4520547945205475,97.74543378995433,95.54794520547945,2.1974885844748857,2.254566210045662
09020701,09,02,07,01,527,321,221,206,15,306,100.0,60.91081593927894,41.935483870967744,39.08918406072106,2.846299810246679,58.06451612903226
09020702,09,02,07,02,16003,1584,14928,14419,509,1075,100.0,9.898144097981628,93.28250952946323,90.10185590201837,3.1806536274448542,6.717490470536775
09020801,09,02,08,01,2897,143,2822,2754,68,75,100.0,4.936140835346911,97.41111494649638,95.06385916465308,2.347255781843286,2.5888850535036245
09020802,09,02,08,02,7257,806,6770,6451,319,487,100.0,11.106517844839466,93.28923797712554,88.89348215516053,4.3957558219649995,6.710762022874466
09030901,09,03,09,01,12560,1300,11911,11260,651,649,100.0,10.35031847133758,94.8328025477707,89.64968152866241,5.18312101910828,5.167197452229299
09030902,09,03,09,02,5854,631,5560,5223,337,294,100.0,10.778954560983943,94.97779296207722,89.22104543901605,5.756747523061155,5.022207037922788
09030903,09,03,09,03,7789,957,7512,6832,680,277,100.0,12.28655796636282,96.44370265759405,87.71344203363718,8.730260623956863,3.556297342405957
09031001,09,03,10,01,12307,879,11834,11428,406,473,100.0,7.14227675306736,96.15665881205818,92.85772324693265,3.298935565125538,3.843341187941822
09031101,09,03,11,01,5714,454,5395,5260,135,319,100.0,7.945397269863492,94.41722086104305,92.05460273013651,2.3626181309065455,5.582779138956948
09031201,09,03,12,01,1774,115,1726,1659,67,48,100.0,6.482525366403608,97.29425028184893,93.5174746335964,3.7767756482525368,2.705749718151071
09031202,09,03,12,02,2361,153,2271,2208,63,90,100.0,6.480304955527319,96.18805590851333,93.51969504447268,2.6683608640406606,3.8119440914866582
09041301,09,04,13,01,14253,905,13637,13348,289,616,100.0,6.349540447625062,95.67810285553918,93.65045955237494,2.0276433031642465,4.321897144460815
09041302,09,04,13,02,1794,110,1757,1684,73,37,100.0,6.131549609810479,97.93756967670011,93.86845039018952,4.069119286510591,2.0624303232998886
09041401,09,04,14,01,4827,547,4391,4280,111,436,100.0,11.33209032525378,90.96747462191837,88.66790967474621,2.2995649471721564,9.032525378081624
09041402,09,04,14,02,1468,131,1430,1337,93,38,100.0,8.923705722070844,97.41144414168937,91.07629427792916,6.335149863760218,2.588555858310627
09041501,09,04,15,01,7146,759,6759,6387,372,387,100.0,10.621326616288833,94.58438287153652,89.37867338371117,5.205709487825357,5.415617128463476
09041601,09,04,16,01,6511,279,6396,6232,164,115,100.0,4.285056058977116,98.23375825526033,95.7149439410229,2.518814314237444,1.7662417447396712
09051701,09,05,17,01,3500,130,3424,3370,54,76,100.0,3.7142857142857144,97.82857142857144,96.28571428571429,1.542857142857143,2.1714285714285713
09051702,09,05,17,02,14368,685,14024,13683,341,344,100.0,4.767538975501114,97.60579064587974,95.23246102449889,2.3733296213808464,2.3942093541202674
09051801,09,05,18,01,9086,502,8854,8584,270,232,100.0,5.524983491085186,97.44662117543473,94.4750165089148,2.9716046665199207,2.5533788245652653
09051901,09,05,19,01,10085,642,9742,9443,299,343,100.0,6.365889935547843,96.59890927119484,93.63411006445216,2.964799206742687,3.401090728805156
09052001,09,05,20,01,12347,582,12051,11765,286,296,100.0,4.7136956345671015,97.60265651575281,95.2863043654329,2.316352150319916,2.3973434842471852
10010101,10,01,01,01,5577,1244,5055,4333,722,522,100.0,22.305899228976152,90.64012910166757,77.69410077102384,12.946028330643717,9.359870898332437
10010102,10,01,01,02,17803,3766,16395,14037,2358,1408,100.0,21.15373813402236,92.091220580801,78.84626186597764,13.244958714823344,7.908779419199011
10010203,10,01,02,03,809,369,497,440,57,312,100.0,45.611866501854145,61.43386897404203,54.38813349814586,7.045735475896168,38.56613102595797
10010204,10,01,02,04,10268,1907,9634,8361,1273,634,100.0,18.572263342423064,93.82547721075186,81.42773665757694,12.397740553174913,6.17452278924815
10010205,10,01,02,05,8027,902,7636,7125,511,391,100.0,11.237074872305968,95.12893982808023,88.76292512769403,6.366014700386197,4.871060171919771
10010206,10,01,02,06,16437,2693,15220,13744,1476,1217,100.0,16.383768327553693,92.59597250106467,83.6162316724463,8.979740828618361,7.404027498935328
10010207,10,01,02,07,10692,2160,9782,8532,1250,910,100.0,20.2020202020202,91.48896371118593,79.7979797979798,11.690983913206136,8.511036288814067
10010308,10,01,03,08,1985,386,1762,1599,163,223,100.0,19.445843828715365,88.76574307304786,80.55415617128463,8.211586901763223,11.23425692695214
10010309,10,01,03,09,14353,2610,13386,11743,1643,967,100.0,18.184351703476626,93.26273252978471,81.81564829652338,11.447084233261338,6.7372674702152855
10010310,10,01,03,10,17747,2861,16669,14886,1783,1078,100.0,16.12103454104919,93.92573392686087,83.8789654589508,10.04676846791007,6.074266073139122
10010311,10,01,03,11,2942,376,2858,2566,292,84,100.0,12.780421481985044,97.14479945615227,87.21957851801496,9.925220938137322,2.8552005438477224
10020412,10,02,04,12,6687,1627,5937,5060,877,750,100.0,24.33079108718409,88.78420816509646,75.6692089128159,13.114999252280542,11.215791834903545
10020413,10,02,04,13,15054,1845,14188,13209,979,866,100.0,12.255878836189718,94.24737611266109,87.74412116381029,6.503254948850803,5.752623887338913
10020414,10,02,04,14,1647,579,1534,1068,466,113,100.0,35.154826958105645,93.1390406800243,64.84517304189436,28.29386763812993,6.860959319975714
10020415,10,02,04,15,5399,947,4785,4452,333,614,100.0,17.54028523800704,88.62752361548435,82.45971476199297,6.167808853491388,11.37247638451565
10020416,10,02,04,16,5531,1244,4810,4287,523,721,100.0,22.491412041222205,86.96438257096366,77.5085879587778,9.45579461218586,13.035617429036343
10020517,10,02,05,17,8794,635,8542,8159,383,252,100.0,7.220832385717535,97.13440982488059,92.77916761428247,4.355242210598135,2.8655901751193995
10020518,10,02,05,18,5117,536,4835,4581,254,282,100.0,10.474887629470393,94.4889583740473,89.5251123705296,4.963846003517687,5.511041625952707
10020519,10,02,05,19,5879,1415,4825,4464,361,1054,100.0,24.068719169926858,82.07178091512162,75.93128083007315,6.140500085048477,17.92821908487838
10020620,10,02,06,20,3328,433,3148,2895,253,180,100.0,13.010817307692307,94.59134615384616,86.9891826923077,7.602163461538461,5.408653846153847
10020621,10,02,06,21,5999,715,5642,5284,358,357,100.0,11.918653108851474,94.04900816802801,88.08134689114853,5.96766127687948,5.950991831971995
10020622,10,02,06,22,8706,921,8332,7785,547,374,100.0,10.578911095796002,95.70411210659316,89.421088904204,6.283023202389157,4.295887893406846
10020623,10,02,06,23,6542,578,6349,5964,385,193,100.0,8.835218587587894,97.04983185570161,91.16478141241211,5.885050443289514,2.9501681442983796
10030724,10,03,07,24,7737,1043,7023,6694,329,714,100.0,13.480677265089827,90.77161690577744,86.51932273491018,4.252294170867262,9.228383094222567
10030725,10,03,07,25,5818,699,5486,5119,367,332,100.0,12.014437951185975,94.29357167411482,87.98556204881403,6.308009625300791,5.706428325885184
10030726,10,03,07,26,2887,227,2799,2660,139,88,100.0,7.862833391063388,96.95185313474195,92.13716660893661,4.8146865258053335,3.0481468652580532
10030727,10,03,07,27,9180,686,8932,8494,438,248,100.0,7.472766884531589,97.29847494553377,92.5272331154684,4.771241830065359,2.701525054466231
10040828,10,04,08,28,7582,385,7423,7197,226,159,100.0,5.077815879715115,97.90292798733843,94.92218412028488,2.980743867053548,2.0970720126615667
10040829,10,04,08,29,3574,171,3485,3403,82,89,100.0,4.7845551203133745,97.50979294907667,95.21544487968663,2.294348069390039,2.490207050923335
10040830,10,04,08,30,7500,380,7361,7120,241,139,100.0,5.066666666666666,98.14666666666668,94.93333333333334,3.2133333333333334,1.8533333333333333
10040931,10,04,09,31,9141,508,8949,8633,316,192,100.0,5.557378842577398,97.89957335083689,94.44262115742261,3.4569521934142875,2.100426649163111
10040932,10,04,09,32,3922,262,3790,3660,130,132,100.0,6.680265170831208,96.63437021927588,93.3197348291688,3.314635390107088,3.3656297807241207
10040933,10,04,09,33,14441,701,14142,13740,402,299,100.0,4.854234471297001,97.92950626687903,95.145765528703,2.783740738176027,2.070493733120975
11010101,11,01,01,01,580,60,542,520,22,38,100.0,10.344827586206897,93.44827586206897,89.65517241379311,3.793103448275862,6.551724137931035
11010102,11,01,01,02,2542,110,2503,2432,71,39,100.0,4.327301337529504,98.46577498033045,95.6726986624705,2.7930763178599527,1.5342250196695515
11010103,11,01,01,03,1268,94,1237,1174,63,31,100.0,7.413249211356467,97.55520504731862,92.58675078864354,4.968454258675079,2.444794952681388
11010204,11,01,02,04,8861,2051,7871,6810,1061,990,100.0,23.146371741338452,88.82744611217696,76.85362825866156,11.973817853515405,11.172553887823044
11010205,11,01,02,05,6655,1501,5990,5154,836,665,100.0,22.554470323065363,90.00751314800901,77.44552967693463,12.561983471074381,9.992486851990984
11010206,11,01,02,06,5855,890,5399,4965,434,456,100.0,15.200683176771989,92.21178479931682,84.79931682322801,7.412467976088813,7.788215200683177
11010207,11,01,02,07,6905,872,6491,6033,458,414,100.0,12.628530050687909,94.00434467776974,87.3714699493121,6.63287472845764,5.9956553222302675
11010308,11,01,03,08,11045,2268,10055,8777,1278,990,100.0,20.534178361249435,91.03666817564509,79.46582163875057,11.570846536894521,8.963331824354912
11010309,11,01,03,09,9560,1878,8548,7682,866,1012,100.0,19.644351464435147,89.4142259414226,80.35564853556485,9.05857740585774,10.585774058577407
11010310,11,01,03,10,5210,466,5009,4744,265,201,100.0,8.944337811900192,96.14203454894434,91.0556621880998,5.08637236084453,3.8579654510556622
11020411,11,02,04,11,8016,1138,7246,6878,368,770,100.0,14.196606786427147,90.3942115768463,85.80339321357286,4.590818363273453,9.605788423153692
11020412,11,02,04,12,6130,804,5767,5326,441,363,100.0,13.115823817292007,94.07830342577488,86.88417618270799,7.194127243066885,5.921696574225122
11020513,11,02,05,13,3433,207,3335,3226,109,98,100.0,6.0297116224876195,97.1453539178561,93.97028837751238,3.1750655403437222,2.8546460821438977
11020514,11,02,05,14,8441,1165,7557,7276,281,884,100.0,13.801682265134463,89.5273071910911,86.19831773486554,3.3289894562255657,10.472692808908898
11020515,11,02,05,15,14400,2758,12906,11642,1264,1494,100.0,19.15277777777778,89.625,80.84722222222223,8.777777777777777,10.375
11020516,11,02,05,16,3700,299,3573,3401,172,127,100.0,8.08108108108108,96.56756756756756,91.91891891891892,4.648648648648648,3.432432432432433
11030617,11,03,06,17,6101,1640,5128,4461,667,973,100.0,26.88083920668743,84.05179478773972,73.11916079331257,10.932633994427142,15.948205212260286
11030618,11,03,06,18,15768,3231,13953,12537,1416,1815,100.0,20.490867579908674,88.48934550989345,79.50913242009132,8.980213089802131,11.510654490106544
11030619,11,03,06,19,10567,2591,9131,7976,1155,1436,100.0,24.519731238762184,86.41052332733983,75.48026876123781,10.930254566102015,13.589476672660169
11030720,11,03,07,20,5481,3394,2375,2087,288,3106,100.0,61.923006750592954,43.331508848750225,38.076993249407046,5.254515599343185,56.66849115124977
11030721,11,03,07,21,22588,4277,19681,18311,1370,2907,100.0,18.934832654506817,87.13033469098636,81.06516734549318,6.065167345493182,12.869665309013637
11030824,11,03,08,24,10012,2941,8311,7071,1240,1701,100.0,29.374750299640436,83.01038753495806,70.62524970035957,12.385137834598483,16.98961246504195
11040925,11,04,09,25,3644,633,3252,3011,241,392,100.0,17.371020856201977,89.24259055982436,82.62897914379802,6.6136114160263455,10.757409440175632
11040926,11,04,09,26,27464,4339,24745,23125,1620,2719,100.0,15.798863967375473,90.09976696766677,84.20113603262452,5.898630935042237,9.900233032333237
11041022,11,04,10,22,5134,1268,4332,3866,466,802,100.0,24.6980911569926,84.37865212310089,75.3019088430074,9.076743280093494,15.621347876899103
11041023,11,04,10,23,5903,1512,5074,4391,683,829,100.0,25.614094528206,85.95629341013044,74.385905471794,11.57038793833644,14.04370658986956
11041027,11,04,10,27,2701,520,2398,2181,217,303,100.0,19.252128841169938,88.78193261754905,80.74787115883007,8.034061458718993,11.218067382450943
11041128,11,04,11,28,24465,4343,21914,20122,1792,2551,100.0,17.751890455753117,89.57285918659309,82.24810954424689,7.32474964234621,10.427140813406908
11051229,11,05,12,29,3438,436,3233,3002,231,205,100.0,12.681791739383364,94.03723094822571,87.31820826061664,6.719022687609074,5.962769051774288
11051330,11,05,13,30,8406,1279,7505,7127,378,901,100.0,15.215322388769925,89.28146561979538,84.78467761123008,4.496788008565311,10.718534380204616
11051331,11,05,13,31,9593,735,9228,8858,370,365,100.0,7.661836755967894,96.19514229125404,92.33816324403212,3.8569790472219325,3.8048577087459607
11051332,11,05,13,32,6532,614,6266,5918,348,266,100.0,9.399877526025719,95.92774035517454,90.60012247397428,5.327617881200245,4.072259644825475
12103115,12,10,31,15,7448,2725,5961,4723,1238,1487,100.0,36.58700322234157,80.03490870032223,63.412996777658435,16.621911922663802,19.965091299677766
12103116,12,10,31,16,9210,3749,7184,5461,1723,2026,100.0,40.705754614549406,78.00217155266014,59.294245385450594,18.707926167209553,21.99782844733985
12103117,12,10,31,17,10136,4610,7471,5526,1945,2665,100.0,45.48145224940805,73.7075769534333,54.51854775059195,19.189029202841358,26.292423046566693
12103218,12,10,32,18,13032,4777,10624,8255,2369,2408,100.0,36.655923879680785,81.52240638428484,63.344076120319215,18.178330263965623,18.47759361571516
12103219,12,10,32,19,8571,3122,6964,5449,1515,1607,100.0,36.425154591062885,81.25072920312682,63.57484540893711,17.67588379418971,18.749270796873176
12103220,12,10,32,20,4574,1084,4074,3490,584,500,100.0,23.699169217315262,89.06864888500219,76.30083078268474,12.767818102317447,10.931351114997815
12214125,12,21,41,25,7150,1637,6347,5513,834,803,100.0,22.895104895104897,88.76923076923077,77.1048951048951,11.664335664335665,11.23076923076923
12214126,12,21,41,26,7532,2282,6553,5250,1303,979,100.0,30.297397769516728,87.00212426978227,69.70260223048327,17.299522039298992,12.997875730217737
12214421,12,21,44,21,2605,785,2174,1820,354,431,100.0,30.134357005758154,83.45489443378119,69.86564299424184,13.589251439539348,16.54510556621881
12214422,12,21,44,22,7714,4069,5573,3645,1928,2141,100.0,52.74824993518279,72.24526834327197,47.251750064817216,24.993518278454758,27.754731656728026
12214423,12,21,44,23,5491,1815,4663,3676,987,828,100.0,33.0540885084684,84.92077945729375,66.94591149153159,17.974867965762158,15.079220542706246
12214424,12,21,44,24,10323,4594,7627,5729,1898,2696,100.0,44.50256708321225,73.88356098033518,55.49743291678776,18.386128063547417,26.116439019664828
12214527,12,21,45,27,10492,1809,9539,8683,856,953,100.0,17.2417079679756,90.91688905833016,82.7582920320244,8.158597026305756,9.083110941669844
12214528,12,21,45,28,256,58,230,198,32,26,100.0,22.65625,89.84375,77.34375,12.5,10.15625
12224229,12,22,42,29,6029,696,5755,5333,422,274,100.0,11.544203018742744,95.45529938629956,88.45579698125727,6.999502405042296,4.5447006137004475
12224230,12,22,42,30,17834,1888,17094,15946,1148,740,100.0,10.586520130088594,95.850622406639,89.4134798699114,6.437142536727598,4.149377593360995
12231101,12,23,11,01,16266,1721,15497,14545,952,769,100.0,10.580351653756301,95.27234722734538,89.41964834624369,5.852698881101684,4.727652772654617
12231102,12,23,11,02,16627,1672,15997,14955,1042,630,100.0,10.05593312082757,96.21098213748722,89.94406687917244,6.26691525831479,3.7890178625127806
12301203,12,30,12,03,14755,3852,12342,10903,1439,2413,100.0,26.106404608607253,83.64622161978991,73.89359539139275,9.752626228397153,16.353778380210098
12301204,12,30,12,04,6353,1338,5657,5015,642,696,100.0,21.06091610262868,89.04454588383442,78.93908389737132,10.105461986463087,10.955454116165592
12301205,12,30,12,05,4842,708,4567,4134,433,275,100.0,14.622057001239158,94.32052870714581,85.37794299876084,8.942585708384964,5.679471292854193
12301206,12,30,12,06,5003,660,4777,4343,434,226,100.0,13.19208474915051,95.48271037377573,86.80791525084949,8.674795122926245,4.517289626224265
12302107,12,30,21,07,2991,992,2599,1999,600,392,100.0,33.16616516215313,86.89401537947174,66.83383483784688,20.060180541624874,13.105984620528252
12302108,12,30,21,08,13423,4969,11246,8454,2792,2177,100.0,37.01855024957163,83.7815689488192,62.98144975042837,20.80011919839082,16.218431051180808
12302109,12,30,21,09,11193,5270,8499,5923,2576,2694,100.0,47.0829983025105,75.93138568748324,52.91700169748951,23.014383989993746,24.06861431251675
12302110,12,30,21,10,10066,5043,7582,5023,2559,2484,100.0,50.0993443274389,75.32286906417643,49.90065567256109,25.42221339161534,24.677130935823566
12302211,12,30,22,11,3282,738,2989,2544,445,293,100.0,22.486288848263253,91.07251675807434,77.51371115173674,13.558805606337598,8.927483241925655
12302212,12,30,22,12,5571,1955,4588,3616,972,983,100.0,35.09244300843655,82.35505295279124,64.90755699156345,17.447495961227787,17.64494704720876
12304313,12,30,43,13,6467,1160,5805,5307,498,662,100.0,17.937219730941703,89.76341425699707,82.0627802690583,7.700633987938767,10.236585743002937
12304314,12,30,43,14,9666,1143,9156,8523,633,510,100.0,11.824953445065177,94.723774053383,88.17504655493482,6.5487274984481685,5.276225946617008
