id,district_id,forecast_area_id,district_region_id,planning_area_id,inhabitants,inhabitants_with_migration_background,inhabitants_germans,inhabitants_germans_without_migration_background,inhabitants_germans_with_migration_background,inhabitants_foreigners,inhabitants_percentage,inhabitants_with_migration_background_percentage,inhabitants_germans_percentage,inhabitants_germans_without_migration_background_percentage,inhabitants_germans_with_migration_background_percentage,inhabitants_foreigners_percentage
01011101,01,01,11,01,3384,2054,1967,1330,637,1417,100.0,60.69739952718676,58.12647754137116,39.30260047281324,18.82387706855792,41.87352245862884
01011102,01,01,11,02,196,76,129,120,9,67,100.0,38.775510204081634,65.81632653061224,61.224489795918366,4.591836734693878,34.183673469387756
01011103,01,01,11,03,5038,2885,3287,2153,1134,1751,100.0,57.264787614132594,65.24414450178642,42.73521238586741,22.508932115919013,34.75585549821358
01011104,01,01,11,04,4759,3110,2858,1649,1209,1901,100.0,65.34986341668417,60.05463332632907,34.65013658331582,25.40449674301324,39.94536667367094
01011105,01,01,11,05,1421,899,767,522,245,654,100.0,63.26530612244898,53.97607318789584,36.734693877551024,17.24137931034483,46.02392681210416
01011201,01,01,12,01,2405,1438,1419,967,452,986,100.0,59.7920997920998,59.002079002079,40.20790020790021,18.794178794178794,40.997920997921
01011202,01,01,12,02,632,303,401,329,72,231,100.0,47.94303797468354,63.4493670886076,52.05696202531646,11.39240506329114,36.550632911392405
01011203,01,01,12,03,1115,593,707,522,185,408,100.0,53.18385650224216,63.408071748878925,46.81614349775784,16.591928251121075,36.591928251121075
01011204,01,01,12,04,8279,4152,5522,4127,1395,2757,100.0,50.150984418408015,66.69887667592704,49.849015581591985,16.849861094335065,33.301123324072954
01011301,01,01,13,01,6919,2964,4806,3955,851,2113,100.0,42.83856048561931,69.4609047550224,57.161439514380696,12.299465240641712,30.5390952449776
01011302,01,01,13,02,12572,5040,9143,7532,1611,3429,100.0,40.089086859688194,72.72510340439071,59.910913140311806,12.814190264078906,27.274896595609288
01011303,01,01,13,03,9999,4764,6506,5235,1271,3493,100.0,47.64476447644764,65.06650665066506,52.35523552355236,12.711271127112711,34.93349334933493
01011304,01,01,13,04,8761,3644,6473,5117,1356,2288,100.0,41.593425408058444,73.88425978769547,58.40657459194156,15.47768519575391,26.115740212304534
01011305,01,01,13,05,8243,3254,6081,4989,1092,2162,100.0,39.47591896154313,73.7716850661167,60.52408103845687,13.247604027659833,26.228314933883297
01011306,01,01,13,06,10607,4651,7439,5956,1483,3168,100.0,43.84840199868012,70.1329310832469,56.15159800131988,13.98133308192703,29.867068916753087
01011401,01,01,14,01,17948,7792,12281,10156,2125,5667,100.0,43.41430800089147,68.42545130376644,56.58569199910853,11.8397593046579,31.574548696233563
01011402,01,01,14,02,13645,5493,9869,8152,1717,3776,100.0,40.2565042139978,72.32685965555147,59.7434957860022,12.583363869549286,27.673140344448516
01022101,01,02,21,01,3557,1915,2214,1642,572,1343,100.0,53.83750351419736,62.24346359291538,46.16249648580265,16.080967107112734,37.756536407084624
01022102,01,02,21,02,6709,4139,3828,2570,1258,2881,100.0,61.69324787598748,57.057683708451336,38.30675212401252,18.750931584438813,42.942316291548664
01022103,01,02,21,03,272,213,119,59,60,153,100.0,78.30882352941177,43.75,21.691176470588236,22.058823529411764,56.25
01022104,01,02,21,04,18974,9586,12755,9388,3367,6219,100.0,50.52176662801728,67.22356909455044,49.47823337198271,17.745335722567724,32.77643090544956
01022105,01,02,21,05,5426,3234,3357,2192,1165,2069,100.0,59.601916697382975,61.868779948396615,40.398083302617025,21.47069664577958,38.13122005160339
01022106,01,02,21,06,11421,4053,9092,7368,1724,2329,100.0,35.487260309955346,79.60774012783469,64.51273969004465,15.095000437790034,20.39225987216531
01022201,01,02,22,01,11027,5556,7568,5471,2097,3459,100.0,50.38541761131767,68.6315407635803,49.61458238868233,19.01695837489798,31.3684592364197
01022202,01,02,22,02,2495,1554,1622,941,681,873,100.0,62.28456913827656,65.01002004008016,37.71543086172345,27.294589178356716,34.98997995991984
01022203,01,02,22,03,7083,4225,4697,2858,1839,2386,100.0,59.64986587604123,66.31370888041789,40.350134123958775,25.963574756459128,33.686291119582094
01022204,01,02,22,04,6236,2780,4462,3456,1006,1774,100.0,44.57985888389994,71.55227710070558,55.42014111610006,16.132135984605515,28.44772289929442
01022205,01,02,22,05,3349,2121,2222,1228,994,1127,100.0,63.332338011346664,66.34816363093461,36.66766198865333,29.680501642281275,33.65183636906539
01022206,01,02,22,06,3044,1252,2368,1792,576,676,100.0,41.13009198423128,77.79237844940867,58.86990801576872,18.922470433639948,22.207621550591327
01022207,01,02,22,07,5771,2713,3818,3058,760,1953,100.0,47.010916652226655,66.15837809738348,52.989083347773345,13.169294749610119,33.84162190261653
01033101,01,03,31,01,27088,17200,15724,9888,5836,11364,100.0,63.496751329001775,58.047844063792084,36.503248670998225,21.54459539279386,41.952155936207916
01033102,01,03,31,02,12063,7462,7365,4601,2764,4698,100.0,61.85857581032911,61.05446406366576,38.1414241896709,22.91303987399486,38.945535936334245
01033201,01,03,32,01,13919,9338,9626,4581,5045,4293,100.0,67.0881528845463,69.15726704504634,32.911847115453696,36.24541992959264,30.84273295495366
01033202,01,03,32,02,10273,5946,7327,4327,3000,2946,100.0,57.879879295239945,71.32288523313541,42.12012070476005,29.20276452837535,28.677114766864598
01033203,01,03,32,03,14684,9428,8758,5256,3502,5926,100.0,64.20593843639335,59.64314900572051,35.79406156360665,23.849087442113863,40.35685099427948
01044101,01,04,41,01,21023,10358,14386,10665,3721,6637,100.0,49.26984731008895,68.42981496456262,50.730152689911044,17.699662274651573,31.570185035437376
01044102,01,04,41,02,16630,6815,12588,9815,2773,4042,100.0,40.9801563439567,75.69452796151533,59.01984365604329,16.674684305472038,24.305472038484666
01044103,01,04,41,03,8684,4656,5442,4028,1414,3242,100.0,53.615845232611704,62.66697374481806,46.3841547673883,16.282818977429756,37.33302625518194
01044201,01,04,42,01,24356,16713,13567,7643,5924,10789,100.0,68.61964197733617,55.70290688126129,31.380358022663817,24.32254885859747,44.297093118738715
01044202,01,04,42,02,17122,10105,10030,7017,3013,7092,100.0,59.017638126387105,58.57960518631001,40.982361873612895,17.597243312697113,41.42039481368999
01044203,01,04,42,03,16328,9793,9797,6535,3262,6531,100.0,59.97672709456149,60.00122488975992,40.02327290543851,19.97795198432141,39.998775110240075
02010101,02,01,01,01,6823,4940,3762,1883,1879,3061,100.0,72.40216913381211,55.137036494210754,27.597830866187895,27.539205628022863,44.862963505789246
02010102,02,01,01,02,13693,9349,9104,4344,4760,4589,100.0,68.27576133790988,66.48652596217045,31.72423866209012,34.76228730008034,33.513474037829546
02010103,02,01,01,03,15302,10806,9856,4496,5360,5446,100.0,70.61821984054372,64.40988106129917,29.381780159456277,35.0281009018429,35.59011893870082
02010104,02,01,01,04,5086,3315,3425,1771,1654,1661,100.0,65.178922532442,67.34172237514746,34.821077467558005,32.520644907589464,32.65827762485254
02020201,02,02,02,01,1790,690,1406,1100,306,384,100.0,38.547486033519554,78.54748603351955,61.452513966480446,17.094972067039105,21.452513966480446
02020202,02,02,02,02,6099,2722,4326,3377,949,1773,100.0,44.63026725692736,70.92966060009837,55.36973274307263,15.559927857025743,29.070339399901624
02020203,02,02,02,03,11056,4412,8310,6644,1666,2746,100.0,39.90593342981187,75.16280752532562,60.09406657018813,15.068740955137482,24.837192474674385
02020204,02,02,02,04,12808,5537,9271,7271,2000,3537,100.0,43.23079325421612,72.38444722048719,56.76920674578388,15.61524047470331,27.615552779512804
02020205,02,02,02,05,15107,6269,11246,8838,2408,3861,100.0,41.49731912358509,74.44231151121996,58.5026808764149,15.939630634805058,25.557688488780034
02020206,02,02,02,06,19040,8875,13730,10165,3565,5310,100.0,46.61239495798319,72.11134453781513,53.38760504201681,18.72373949579832,27.888655462184875
02030301,02,03,03,01,8996,5706,5545,3290,2255,3451,100.0,63.428190306803025,61.638506002667846,36.571809693196975,25.066696309470878,38.36149399733215
02030302,02,03,03,02,13131,7131,8851,6000,2851,4280,100.0,54.30660269591044,67.40537658974944,45.69339730408956,21.711979285659886,32.59462341025055
02030401,02,03,04,01,15263,7534,10377,7729,2648,4886,100.0,49.361200288278845,67.98794470287623,50.63879971172116,17.34914499115508,32.012055297123766
02030402,02,03,04,02,11172,5692,7436,5480,1956,3736,100.0,50.94880057286072,66.55925528105979,49.051199427139274,17.508055853920514,33.44074471894021
02040501,02,04,05,01,5390,1551,4524,3839,685,866,100.0,28.775510204081634,83.93320964749536,71.22448979591837,12.708719851576994,16.06679035250464
02040502,02,04,05,02,7443,2290,5985,5153,832,1458,100.0,30.767163778046484,80.41112454655381,69.2328362219535,11.178288324600295,19.588875453446192
02040503,02,04,05,03,11157,2973,9228,8184,1044,1929,100.0,26.64694810432912,82.71040602312449,73.35305189567089,9.357354127453616,17.2895939768755
02040701,02,04,07,01,13151,5550,9571,7601,1970,3580,100.0,42.202113907687625,72.7777355334195,57.79788609231237,14.97984944110714,27.222264466580487
02040702,02,04,07,02,10973,3137,8802,7836,966,2171,100.0,28.588353230657066,80.21507336188827,71.41164676934292,8.803426592545339,19.78492663811173
02040703,02,04,07,03,1155,792,469,363,106,686,100.0,68.57142857142857,40.60606060606061,31.428571428571427,9.177489177489177,59.3939393939394
02050601,02,05,06,01,9124,2871,7106,6253,853,2018,100.0,31.46646207803595,77.88250767207366,68.53353792196405,9.348969750109601,22.117492327926346
02050602,02,05,06,02,21730,6774,16946,14956,1990,4784,100.0,31.173492867004143,77.98435342843995,68.82650713299586,9.157846295444086,22.015646571560055
02050801,02,05,08,01,20028,7043,14908,12985,1923,5120,100.0,35.16576792490513,74.4357898941482,64.83423207509486,9.601557819053326,25.56421010585181
02050802,02,05,08,02,21280,6930,16215,14350,1865,5065,100.0,32.56578947368421,76.19830827067669,67.43421052631578,8.764097744360901,23.801691729323306
02050803,02,05,08,03,7598,2629,5730,4969,761,1868,100.0,34.601210844959205,75.4145827849434,65.3987891550408,10.015793629902605,24.585417215056594
02050804,02,05,08,04,4725,1136,4101,3589,512,624,100.0,24.042328042328045,86.79365079365078,75.95767195767196,10.835978835978837,13.206349206349207
03010101,03,01,01,01,4119,614,3716,3505,211,403,100.0,14.906530711337703,90.21607186210245,85.09346928866229,5.1226025734401555,9.783928137897547
03010102,03,01,01,02,12348,2377,10545,9971,574,1803,100.0,19.25008098477486,85.39844509232265,80.74991901522513,4.648526077097506,14.601554907677356
03010104,03,01,01,04,239,57,209,182,27,30,100.0,23.84937238493724,87.44769874476988,76.15062761506276,11.297071129707113,12.552301255230125
03020203,03,02,02,03,2285,337,2020,1948,72,265,100.0,14.74835886214442,88.40262582056893,85.25164113785559,3.1509846827133483,11.597374179431071
03020209,03,02,02,09,14967,2393,13603,12574,1029,1364,100.0,15.988508051045633,90.8866172245607,84.01149194895436,6.875125275606334,9.1133827754393
03020210,03,02,02,10,11488,1701,10533,9787,746,955,100.0,14.806754874651812,91.68697771587743,85.1932451253482,6.493732590529248,8.313022284122562
03020307,03,02,03,07,18304,2434,17292,15870,1422,1012,100.0,13.29763986013986,94.47115384615384,86.70236013986013,7.768793706293706,5.528846153846153
03030405,03,03,04,05,11352,1912,10269,9440,829,1083,100.0,16.842847075405214,90.45983086680761,83.1571529245948,7.302677942212826,9.54016913319239
03030406,03,03,04,06,8225,722,7926,7503,423,299,100.0,8.778115501519757,96.36474164133737,91.22188449848025,5.142857142857142,3.6352583586626137
03030711,03,03,07,11,6869,502,6665,6367,298,204,100.0,7.308196243994759,97.0301353908866,92.69180375600524,4.338331634881351,2.969864609113408
03030715,03,03,07,15,7664,1477,6647,6187,460,1017,100.0,19.271920668058456,86.73016701461378,80.72807933194154,6.002087682672234,13.26983298538622
03030716,03,03,07,16,1131,41,1112,1090,22,19,100.0,3.6251105216622457,98.32007073386384,96.37488947833775,1.9451812555260832,1.6799292661361624
03040508,03,04,05,08,4588,932,4303,3656,647,285,100.0,20.31386224934612,93.78814298169137,79.68613775065388,14.10200523103749,6.211857018308631
03040512,03,04,05,12,10074,1646,9306,8428,878,768,100.0,16.339090728608298,92.37641453245979,83.6609092713917,8.715505261068095,7.623585467540203
03040513,03,04,05,13,3356,496,3127,2860,267,229,100.0,14.779499404052443,93.17640047675805,85.22050059594756,7.955899880810488,6.823599523241955
03040614,03,04,06,14,36487,5650,33411,30837,2574,3076,100.0,15.484967248609093,91.56960013155371,84.5150327513909,7.054567380162798,8.430399868446296
03040818,03,04,08,18,34800,5989,31000,28811,2189,3800,100.0,17.20977011494253,89.08045977011494,82.79022988505747,6.290229885057472,10.919540229885058
03050919,03,05,09,19,5583,1101,4724,4482,242,859,100.0,19.72058033315422,84.6140068063765,80.27941966684578,4.3345871395307185,15.3859931936235
03050920,03,05,09,20,7430,1096,6799,6334,465,631,100.0,14.75100942126514,91.50740242261104,85.24899057873486,6.258411843876177,8.492597577388963
03050923,03,05,09,23,9674,2127,8256,7547,709,1418,100.0,21.98676865825925,85.34215422782717,78.01323134174075,7.328922886086417,14.657845772172834
03050924,03,05,09,24,6140,1434,5154,4706,448,986,100.0,23.355048859934854,83.9413680781759,76.64495114006515,7.296416938110749,16.058631921824105
03050925,03,05,09,25,9755,1823,8593,7932,661,1162,100.0,18.687852383393132,88.08815991799077,81.31214761660686,6.776012301383906,11.911840082009226
03051017,03,05,10,17,4250,939,3587,3311,276,663,100.0,22.094117647058823,84.39999999999999,77.90588235294118,6.4941176470588236,15.6
03051021,03,05,10,21,6468,760,5957,5708,249,511,100.0,11.750154607297464,92.09956709956711,88.24984539270253,3.849721706864564,7.900432900432901
03051022,03,05,10,22,4651,445,4395,4206,189,256,100.0,9.567834874220598,94.49580735325736,90.4321651257794,4.0636422274779616,5.504192646742636
03061126,03,06,11,26,15688,4663,12486,11025,1461,3202,100.0,29.723355430902597,79.5894951555329,70.2766445690974,9.312850586435491,20.41050484446711
03061131,03,06,11,31,10755,3610,8235,7145,1090,2520,100.0,33.565783356578336,76.56903765690377,66.43421664342166,10.134821013482101,23.430962343096233
03061227,03,06,12,27,14649,3892,12097,10757,1340,2552,100.0,26.56836644139532,82.57901563246638,73.43163355860469,9.147382073861698,17.42098436753362
03061228,03,06,12,28,12787,3090,10697,9697,1000,2090,100.0,24.165167748494564,83.6552748885587,75.83483225150543,7.820442637053257,16.344725111441306
03061332,03,06,13,32,22873,7216,18101,15657,2444,4772,100.0,31.54811349626197,79.13697372447864,68.45188650373804,10.685087220740611,20.863026275521356
03061429,03,06,14,29,10001,1660,9035,8341,694,966,100.0,16.5983401659834,90.34096590340965,83.4016598340166,6.939306069393061,9.659034096590341
03061430,03,06,14,30,4126,1721,2678,2405,273,1448,100.0,41.71110033931168,64.90547746000969,58.28889966068832,6.616577799321377,35.0945225399903
03061434,03,06,14,34,6472,1751,5246,4721,525,1226,100.0,27.055006180469714,81.05686032138443,72.94499381953028,8.111866501854141,18.943139678615577
03061435,03,06,14,35,3941,1163,3146,2778,368,795,100.0,29.51027657954834,79.82745496066988,70.48972342045167,9.337731540218218,20.17254503933012
03061441,03,06,14,41,2660,736,2268,1924,344,392,100.0,27.669172932330827,85.26315789473684,72.33082706766916,12.93233082706767,14.736842105263156
03071536,03,07,15,36,11137,4043,8375,7094,1281,2762,100.0,36.302415372182814,75.19978450211008,63.697584627817186,11.502199874292897,24.800215497889916
03071537,03,07,15,37,16027,5621,12159,10406,1753,3868,100.0,35.07206588881263,75.86572658638548,64.92793411118737,10.937792475198103,24.134273413614526
03071633,03,07,16,33,3229,988,2583,2241,342,646,100.0,30.59770826881387,79.99380613192939,69.40229173118612,10.591514400743264,20.00619386807061
03071638,03,07,16,38,17709,5660,13961,12049,1912,3748,100.0,31.961149697893728,78.83562030605906,68.03885030210627,10.796770003952792,21.164379693940933
03071639,03,07,16,39,12738,3424,10574,9314,1260,2164,100.0,26.880200973465225,83.01146176793846,73.11979902653478,9.891662741403675,16.988538232061547
04010101,04,01,01,01,10785,5120,7850,5665,2185,2935,100.0,47.473342605470556,72.7862772369031,52.526657394529444,20.259619842373667,27.213722763096893
04010102,04,01,01,02,812,337,518,475,43,294,100.0,41.502463054187196,63.793103448275865,58.49753694581281,5.295566502463054,36.206896551724135
04010103,04,01,01,03,7881,4284,5760,3597,2163,2121,100.0,54.358583936048724,73.08717167872098,45.641416063951276,27.445755614769702,26.912828321279026
04020204,04,02,02,04,181,63,145,118,27,36,100.0,34.806629834254146,80.11049723756905,65.19337016574586,14.917127071823206,19.88950276243094
04020205,04,02,02,05,1329,339,1135,990,145,194,100.0,25.5079006772009,85.4025583145222,74.4920993227991,10.9104589917231,14.597441685477802
04020206,04,02,02,06,2869,815,2374,2054,320,495,100.0,28.40711049146044,82.74660160334612,71.59288950853956,11.153712094806552,17.253398396653886
04020207,04,02,02,07,2559,767,2107,1792,315,452,100.0,29.9726455646737,82.336850332161,70.02735443532629,12.3094958968347,17.663149667839
04020208,04,02,02,08,2922,784,2509,2138,371,413,100.0,26.830937713894592,85.86584531143052,73.1690622861054,12.69678302532512,14.134154688569472
04020209,04,02,02,09,3214,1241,2272,1973,299,942,100.0,38.612321095208465,70.69072806471686,61.38767890479153,9.303049159925326,29.30927193528314
04020310,04,02,03,10,616,338,335,278,57,281,100.0,54.87012987012987,54.38311688311688,45.12987012987013,9.253246753246753,45.616883116883116
04020311,04,02,03,11,15071,5049,12015,10022,1993,3056,100.0,33.50142658085064,79.72264614159644,66.49857341914937,13.224072722447083,20.277353858403558
04020312,04,02,03,12,5552,1793,4443,3759,684,1109,100.0,32.294668587896254,80.02521613832853,67.70533141210375,12.319884726224783,19.97478386167147
04020313,04,02,03,13,7452,2881,5682,4571,1111,1770,100.0,38.66076221148685,76.24798711755234,61.339237788513145,14.908749329039184,23.752012882447666
04020314,04,02,03,14,12,12,0,0,0,12,100.0,100.0,0.0,0.0,0.0,100.0
04030415,04,03,04,15,3048,1618,1853,1430,423,1195,100.0,53.08398950131233,60.79396325459317,46.91601049868767,13.877952755905513,39.20603674540683
04030416,04,03,04,16,10652,5221,7757,5431,2326,2895,100.0,49.0142696207285,72.8220052572287,50.9857303792715,21.83627487795719,27.17799474277131
04030417,04,03,04,17,10976,4294,8414,6682,1732,2562,100.0,39.12172011661808,76.65816326530613,60.87827988338192,15.779883381924197,23.341836734693878
04030518,04,03,05,18,9581,4335,6978,5246,1732,2603,100.0,45.24579897714226,72.83164596597432,54.75420102285774,18.077444943116586,27.168354034025676
04030519,04,03,05,19,5901,2715,4277,3186,1091,1624,100.0,46.009150991357394,72.47924080664293,53.990849008642606,18.48839179800034,27.52075919335706
04030620,04,03,06,20,8887,3973,6558,4914,1644,2329,100.0,44.705749971869025,73.79318105097333,55.294250028130975,18.498931022842356,26.206818949026665
04030621,04,03,06,21,3026,1750,1947,1276,671,1079,100.0,57.832121612690024,64.34236615994713,42.16787838730998,22.174487772637143,35.657633840052874
04030622,04,03,06,22,10833,5152,7838,5681,2157,2995,100.0,47.5583864118896,72.3529954767839,52.4416135881104,19.9113818886735,27.6470045232161
04030623,04,03,06,23,5049,2849,3406,2200,1206,1643,100.0,56.42701525054466,67.4589027530204,43.57298474945534,23.885918003565063,32.541097246979604
04030724,04,03,07,24,6490,2450,5027,4040,987,1463,100.0,37.750385208012325,77.45762711864407,62.249614791987675,15.208012326656394,22.54237288135593
04030725,04,03,07,25,12302,5023,9090,7279,1811,3212,100.0,40.830759226142085,73.89042432124859,59.169240773857915,14.721183547390668,26.109575678751423
04030726,04,03,07,26,5795,2633,4152,3162,990,1643,100.0,45.43572044866264,71.64797238999138,54.56427955133736,17.083692838654013,28.35202761000863
04030827,04,03,08,27,12235,6611,7948,5624,2324,4287,100.0,54.033510420923584,64.96117695136903,45.966489579076416,18.994687372292603,35.03882304863098
04030828,04,03,08,28,9668,4417,6808,5251,1557,2860,100.0,45.68680182043856,70.41787339677286,54.31319817956144,16.10467521721142,29.582126603227145
04030929,04,03,09,29,6072,2664,4425,3408,1017,1647,100.0,43.873517786561266,72.87549407114624,56.126482213438734,16.74901185770751,27.124505928853754
04030930,04,03,09,30,5649,2596,4008,3053,955,1641,100.0,45.95503628960878,70.9506107275624,54.04496371039122,16.90564701717118,29.049389272437597
04030931,04,03,09,31,3711,2144,2245,1567,678,1466,100.0,57.77418485583401,60.49582322824036,42.225815144166,18.270008084074373,39.50417677175964
04031032,04,03,10,32,15628,6695,11585,8933,2652,4043,100.0,42.83977476324546,74.12976708471973,57.16022523675455,16.969541847965193,25.870232915280265
04041133,04,04,11,33,60,29,31,31,0,29,100.0,48.333333333333336,51.66666666666667,51.66666666666667,0.0,48.333333333333336
04041134,04,04,11,34,5228,2104,4100,3124,976,1128,100.0,40.24483550114767,78.4238714613619,59.75516449885233,18.668706962509564,21.576128538638102
04041135,04,04,11,35,2829,1036,2277,1793,484,552,100.0,36.62071403322729,80.48780487804879,63.37928596677271,17.108518911276068,19.51219512195122
04041136,04,04,11,36,3072,1091,2484,1981,503,588,100.0,35.51432291666667,80.859375,64.48567708333334,16.373697916666664,19.140625
04041137,04,04,11,37,8280,3184,6535,5096,1439,1745,100.0,38.45410628019324,78.92512077294685,61.54589371980676,17.3792270531401,21.074879227053138
04041238,04,04,12,38,6086,2147,5058,3939,1119,1028,100.0,35.27768649359185,83.10877423595137,64.72231350640814,18.386460729543213,16.891225764048638
04041239,04,04,12,39,353,275,100,78,22,253,100.0,77.90368271954674,28.328611898016998,22.096317280453256,6.232294617563739,71.671388101983
04041240,04,04,12,40,1522,423,1300,1099,201,222,100.0,27.792378449408673,85.41392904073587,72.20762155059133,13.206307490144548,14.586070959264127
04041241,04,04,12,41,7031,1752,6072,5279,793,959,100.0,24.918219314464515,86.36040392547291,75.08178068553548,11.27862323993742,13.639596074527095
04041342,04,04,13,42,4141,1407,3381,2734,647,760,100.0,33.9773001690413,81.64694518232311,66.02269983095871,15.624245351364404,18.353054817676888
04041343,04,04,13,43,3556,1122,2977,2434,543,579,100.0,31.55230596175478,83.71766029246345,68.44769403824522,15.269966254218224,16.282339707536558
04041344,04,04,13,44,10810,3000,9078,7810,1268,1732,100.0,27.752081406105454,83.97779833487512,72.24791859389454,11.729879740980573,16.022201665124886
04051445,04,05,14,45,6325,2741,4850,3584,1266,1475,100.0,43.33596837944664,76.6798418972332,56.66403162055336,20.01581027667984,23.3201581027668
04051446,04,05,14,46,10778,4711,8069,6067,2002,2709,100.0,43.709408053442196,74.86546669140843,56.2905919465578,18.57487474485062,25.13453330859158
04051447,04,05,14,47,5365,2264,4043,3101,942,1322,100.0,42.19944082013048,75.358807082945,57.80055917986952,17.55824790307549,24.641192917054987
04051448,04,05,14,48,9367,4452,6545,4915,1630,2822,100.0,47.52855770257286,69.87295825771325,52.47144229742714,17.40151596028611,30.127041742286753
04051549,04,05,15,49,4642,2021,3377,2621,756,1265,100.0,43.53726841878501,72.74881516587678,56.462731581214996,16.286083584661785,27.251184834123222
04051550,04,05,15,50,5574,2325,4174,3249,925,1400,100.0,41.71151776103337,74.88338715464657,58.28848223896663,16.59490491567994,25.116612845353426
04051551,04,05,15,51,4518,1947,3411,2571,840,1107,100.0,43.09428950863214,75.4980079681275,56.90571049136787,18.59229747675963,24.50199203187251
04051652,04,05,16,52,9914,3970,7453,5944,1509,2461,100.0,40.044381682469236,75.17651805527537,59.95561831753077,15.220899737744602,24.82348194472463
04051653,04,05,16,53,6993,2977,5190,4016,1174,1803,100.0,42.57114257114257,74.21707421707421,57.42885742885743,16.78821678821679,25.78292578292578
04051654,04,05,16,54,3055,1091,2398,1964,434,657,100.0,35.711947626841244,78.49427168576105,64.28805237315875,14.206219312602292,21.505728314238954
04051655,04,05,16,55,7300,3162,5438,4138,1300,1862,100.0,43.31506849315068,74.4931506849315,56.68493150684931,17.80821917808219,25.506849315068493
04051656,04,05,16,56,7698,2505,6227,5193,1034,1471,100.0,32.54091971940764,80.89114055598857,67.45908028059236,13.432060275396207,19.10885944401143
04061757,04,06,17,57,72,24,54,48,6,18,100.0,33.33333333333333,75.0,66.66666666666666,8.333333333333332,25.0
05010101,05,01,01,01,10290,2874,8886,7416,1470,1404,100.0,27.930029154518948,86.35568513119534,72.06997084548105,14.285714285714285,13.644314868804663
05010102,05,01,01,02,7193,2230,5842,4963,879,1351,100.0,31.002363408869734,81.21785068816905,68.99763659113026,12.220214097038788,18.78214931183095
05010103,05,01,01,03,7738,1445,7051,6293,758,687,100.0,18.674075988627553,91.12173688291549,81.32592401137245,9.795812871543035,8.878263117084519
05010204,05,01,02,04,3608,1563,2719,2045,674,889,100.0,43.32039911308204,75.36031042128603,56.67960088691796,18.68070953436807,24.63968957871397
05010205,05,01,02,05,1960,579,1735,1381,354,225,100.0,29.54081632653061,88.5204081632653,70.45918367346938,18.06122448979592,11.479591836734695
05010206,05,01,02,06,10613,4239,8443,6374,2069,2170,100.0,39.94158107980778,79.55337793272402,60.05841892019221,19.4949590125318,20.44662206727598
05010207,05,01,02,07,11618,5916,8995,5702,3293,2623,100.0,50.92098467894645,77.42296436563953,49.07901532105354,28.343949044585987,22.577035634360477
05010208,05,01,02,08,7715,2705,6122,5010,1112,1593,100.0,35.06156837329877,79.35191186001296,64.93843162670123,14.413480233311732,20.64808813998704
05010209,05,01,02,09,6103,1920,5197,4183,1014,906,100.0,31.4599377355399,85.1548418810421,68.5400622644601,16.61477961658201,14.84515811895789
05010310,05,01,03,10,3974,1491,3090,2483,607,884,100.0,37.51887267237041,77.75541016607951,62.48112732762959,15.274282838449924,22.244589833920482
05010311,05,01,03,11,5681,2853,4308,2828,1480,1373,100.0,50.22003168456257,75.83171976764655,49.77996831543742,26.051751452209114,24.16828023235346
05010312,05,01,03,12,7394,4174,4378,3220,1158,3016,100.0,56.45117662969976,59.210170408439275,43.54882337030024,15.66134703813903,40.789829591560725
05010313,05,01,03,13,6916,2914,5077,4002,1075,1839,100.0,42.13418160786582,73.40948525159051,57.86581839213418,15.543666859456334,26.590514748409483
05010314,05,01,03,14,12412,4964,9559,7448,2111,2853,100.0,39.99355462455688,77.01417982597486,60.00644537544312,17.007734450531746,22.985820174025136
05010339,05,01,03,39,995,675,384,320,64,611,100.0,67.8391959798995,38.5929648241206,32.1608040201005,6.432160804020101,61.4070351758794
05020415,05,02,04,15,3862,798,3643,3064,579,219,100.0,20.66286897980321,94.32936302433971,79.3371310201968,14.992232004142931,5.67063697566028
05020416,05,02,04,16,1685,88,1659,1597,62,26,100.0,5.222551928783383,98.45697329376854,94.77744807121663,3.6795252225519293,1.543026706231454
05020417,05,02,04,17,5962,1860,5013,4102,911,949,100.0,31.19758470311976,84.08252264340825,68.80241529688024,15.28010734652801,15.917477356591746
05020418,05,02,04,18,4392,1168,3690,3224,466,702,100.0,26.59380692167577,84.01639344262296,73.40619307832422,10.610200364298725,15.983606557377051
05020419,05,02,04,19,7117,2024,6099,5093,1006,1018,100.0,28.438948995363216,85.69622031754953,71.5610510046368,14.135169312912744,14.303779682450472
05020420,05,02,04,20,969,193,874,776,98,95,100.0,19.917440660474718,90.19607843137256,80.08255933952529,10.113519091847266,9.803921568627452
05020521,05,02,05,21,3235,878,2935,2357,578,300,100.0,27.14064914992272,90.72642967542504,72.85935085007728,17.86707882534776,9.273570324574962
05020522,05,02,05,22,7436,3525,5176,3911,1265,2260,100.0,47.404518558364714,69.60731576116191,52.595481441635286,17.011834319526628,30.392684238838086
05020523,05,02,05,23,12761,7392,8941,5369,3572,3820,100.0,57.926494788809656,70.06504192461406,42.073505211190344,27.991536713423713,29.934958075385943
05020524,05,02,05,24,6328,1363,5709,4965,744,619,100.0,21.539190897597976,90.2180783817952,78.46080910240202,11.757269279393173,9.781921618204805
05020625,05,02,06,25,7664,2789,6045,4875,1170,1619,100.0,36.39091858037578,78.87526096033403,63.60908141962421,15.266179540709812,21.12473903966597
05020626,05,02,06,26,18379,6383,14461,11996,2465,3918,100.0,34.72985472550193,78.68219163175362,65.27014527449808,13.412046357255564,21.317808368246368
05020627,05,02,06,27,4440,1988,3187,2452,735,1253,100.0,44.77477477477477,71.77927927927928,55.22522522522523,16.554054054054053,28.22072072072072
05020628,05,02,06,28,2041,505,1808,1536,272,233,100.0,24.742773150416465,88.58402743753062,75.25722684958353,13.326800587947085,11.415972562469378
05020629,05,02,06,29,4420,720,4088,3700,388,332,100.0,16.289592760180994,92.48868778280543,83.710407239819,8.778280542986424,7.51131221719457
05030730,05,03,07,30,4026,2176,3286,1850,1436,740,100.0,54.048683556880285,81.61947342275211,45.95131644311972,35.668156979632386,18.38052657724789
05030731,05,03,07,31,11699,4941,9350,6758,2592,2349,100.0,42.23437900675272,79.92136080006838,57.76562099324729,22.155739806821096,20.07863919993162
05030832,05,03,08,32,12065,5452,9044,6613,2431,3021,100.0,45.18856195607128,74.96062992125985,54.81143804392872,20.149191877331123,25.03937007874016
05030833,05,03,08,33,512,231,401,281,120,111,100.0,45.1171875,78.3203125,54.8828125,23.4375,21.6796875
05040934,05,04,09,34,3539,915,2992,2624,368,547,100.0,25.85476123198644,84.54365640011302,74.14523876801357,10.398417632099463,15.456343599886974
05040935,05,04,09,35,454,105,386,349,37,68,100.0,23.127753303964756,85.02202643171806,76.87224669603523,8.149779735682818,14.977973568281937
05040936,05,04,09,36,10014,1732,9434,8282,1152,580,100.0,17.295785899740363,94.20810864789296,82.70421410025963,11.503894547633314,5.79189135210705
05040937,05,04,09,37,2195,340,2081,1855,226,114,100.0,15.489749430523919,94.80637813211845,84.51025056947609,10.29612756264237,5.193621867881549
05040938,05,04,09,38,3675,503,3488,3172,316,187,100.0,13.687074829931973,94.91156462585035,86.31292517006803,8.598639455782314,5.08843537414966
06010101,06,01,01,01,6964,1811,6014,5153,861,950,100.0,26.005169442848935,86.35841470419298,73.99483055715106,12.36358414704193,13.641585295807007
06010102,06,01,01,02,8836,3167,7126,5669,1457,1710,100.0,35.84200995925758,80.64735174287007,64.15799004074242,16.48936170212766,19.35264825712992
06010103,06,01,01,03,6336,1992,5347,4344,1003,989,100.0,31.439393939393938,84.39078282828282,68.56060606060606,15.830176767676768,15.609217171717171
06010204,06,01,02,04,6885,2313,5757,4572,1185,1128,100.0,33.59477124183007,83.61655773420479,66.40522875816993,17.21132897603486,16.383442265795207
06010205,06,01,02,05,9823,3119,8211,6704,1507,1612,100.0,31.752010587396928,83.58953476534664,68.24798941260308,15.34154535274356,16.410465234653365
06010206,06,01,02,06,7745,2229,6579,5516,1063,1166,100.0,28.77985797288573,84.94512588766946,71.22014202711426,13.724983860555199,15.054874112330536
06010207,06,01,02,07,7850,2561,6531,5289,1242,1319,100.0,32.62420382165605,83.19745222929936,67.37579617834395,15.821656050955413,16.802547770700638
06010208,06,01,02,08,6715,1999,5677,4716,961,1038,100.0,29.769173492181682,84.54206999255398,70.23082650781832,14.311243484735666,15.457930007446016
06010209,06,01,02,09,9227,3095,7581,6132,1449,1646,100.0,33.542863335862144,82.16104909504715,66.45713666413786,15.70391243090929,17.838950904952856
06010210,06,01,02,10,4939,1393,4198,3546,652,741,100.0,28.204089896740232,84.99696294796517,71.79591010325977,13.201052844705405,15.003037052034825
06020301,06,02,03,01,5034,1140,4488,3894,594,546,100.0,22.64600715137068,89.15375446960667,77.35399284862932,11.799761620977355,10.846245530393325
06020302,06,02,03,02,5651,1420,4995,4231,764,656,100.0,25.12829587683596,88.39143514422226,74.87170412316404,13.51973102105822,11.608564855777738
06020303,06,02,03,03,7366,2215,6208,5151,1057,1158,100.0,30.070594623947866,84.2791202823785,69.92940537605213,14.349714906326364,15.720879717621505
06020304,06,02,03,04,7211,2082,6158,5129,1029,1053,100.0,28.872555817501038,85.39730966578838,71.12744418249896,14.269865483289419,14.602690334211621
06020305,06,02,03,05,11414,3841,9423,7573,1850,1991,100.0,33.65165586122306,82.55650954967584,66.34834413877694,16.208165410898896,17.443490450324166
06020306,06,02,03,06,6438,1233,5906,5205,701,532,100.0,19.151910531220874,91.73656415035725,80.84808946877912,10.88847468157813,8.263435849642747
06020407,06,02,04,07,4644,2298,3478,2346,1132,1166,100.0,49.48320413436693,74.89233419465977,50.51679586563308,24.375538329026703,25.107665805340222
06020408,06,02,04,08,6922,1903,5881,5019,862,1041,100.0,27.492054319560822,84.96099393238948,72.50794568043918,12.453048251950303,15.039006067610517
06020409,06,02,04,09,8282,2052,7177,6230,947,1105,100.0,24.7766240038638,86.65781212267568,75.2233759961362,11.434436126539484,13.342187877324319
06020410,06,02,04,10,7166,1406,6356,5760,596,810,100.0,19.620429807423946,88.69662294166899,80.37957019257605,8.31705274909294,11.303377058331007
06020411,06,02,04,11,8575,2145,7586,6430,1156,989,100.0,25.014577259475217,88.466472303207,74.98542274052478,13.481049562682216,11.533527696793003
06030501,06,03,05,01,5748,1325,4935,4423,512,813,100.0,23.051496172581768,85.85594989561586,76.94850382741824,8.907446068197634,14.144050104384135
06030502,06,03,05,02,5640,1315,4967,4325,642,673,100.0,23.31560283687943,88.06737588652483,76.68439716312056,11.382978723404255,11.932624113475178
06030503,06,03,05,03,11872,3392,10102,8480,1622,1770,100.0,28.57142857142857,85.09097035040432,71.42857142857143,13.662398921832883,14.909029649595688
06030504,06,03,05,04,11062,2419,9863,8643,1220,1199,100.0,21.867655035255833,89.16109202675827,78.13234496474418,11.028747062014101,10.838907973241728
06030605,06,03,06,05,7108,2000,6036,5108,928,1072,100.0,28.137310073157007,84.91840180078785,71.86268992684299,13.05571187394485,15.081598199212154
06030606,06,03,06,06,5273,1733,4292,3540,752,981,100.0,32.86554143751185,81.39578987293761,67.13445856248813,14.26133131044946,18.604210127062395
06030607,06,03,06,07,3118,1134,2319,1984,335,799,100.0,36.36946760744067,74.37459910198847,63.63053239255934,10.744066709429122,25.625400898011545
06030608,06,03,06,08,13667,3842,11794,9825,1969,1873,100.0,28.11150947537865,86.29545620838516,71.88849052462135,14.406965683763811,13.70454379161484
06030609,06,03,06,09,12208,3028,10578,9180,1398,1630,100.0,24.80340760157274,86.6480996068152,75.19659239842727,11.451507208387943,13.351900393184795
06030610,06,03,06,10,8502,1987,7431,6515,916,1071,100.0,23.37097153610915,87.4029640084686,76.62902846389085,10.773935544577746,12.597035991531405
06040701,06,04,07,01,10246,2244,9041,8002,1039,1205,100.0,21.901229748194417,88.23931290259614,78.09877025180558,10.140542650790554,11.760687097403864
06040702,06,04,07,02,5506,1296,4851,4210,641,655,100.0,23.537958590628406,88.10388666908827,76.4620414093716,11.641845259716673,11.896113330911733
06040703,06,04,07,03,11156,3224,8915,7932,983,2241,100.0,28.89924704195052,79.91215489422731,71.10075295804948,8.811401936177841,20.08784510577268
06040804,06,04,08,04,7609,1441,6874,6168,706,735,100.0,18.938099618872386,90.34038638454462,81.06190038112761,9.278486003417006,9.659613615455381
06040805,06,04,08,05,5345,1152,4759,4193,566,586,100.0,21.55285313376988,89.03648269410664,78.44714686623013,10.58933582787652,10.963517305893358
06040806,06,04,08,06,7313,1168,6712,6145,567,601,100.0,15.971557500341858,91.78175851223848,84.02844249965814,7.753316012580336,8.21824148776152
06040807,06,04,08,07,5927,1395,5206,4532,674,721,100.0,23.53635903492492,87.83532984646533,76.46364096507507,11.371688881390247,12.164670153534672
06040808,06,04,08,08,4666,1737,3985,2929,1056,681,100.0,37.22674667809687,85.40505786540933,62.773253321903134,22.631804543506213,14.594942134590655
06040809,06,04,08,09,4999,1532,4071,3467,604,928,100.0,30.64612922584517,81.43628725745148,69.35387077415484,12.08241648329666,18.56371274254851
06040810,06,04,08,10,7089,2217,5872,4872,1000,1217,100.0,31.273804485823103,82.83255748342503,68.7261955141769,14.10636196924813,17.167442516574976
07010101,07,01,01,01,9984,4942,6977,5042,1935,3007,100.0,49.499198717948715,69.8818108974359,50.50080128205128,19.381009615384613,30.118189102564102
07010102,07,01,01,02,16634,9548,10696,7086,3610,5938,100.0,57.40050498977997,64.30203198268607,42.59949501022003,21.70253697246603,35.69796801731393
07010103,07,01,01,03,10641,4206,8080,6435,1645,2561,100.0,39.52636030448266,75.93271309087491,60.473639695517335,15.459073395357578,24.067286909125084
07010104,07,01,01,04,13820,7921,9044,5899,3145,4776,100.0,57.31548480463097,65.44138929088278,42.68451519536903,22.756874095513748,34.55861070911722
07020201,07,02,02,01,10705,3856,8596,6849,1747,2109,100.0,36.02055114432508,80.29892573563755,63.97944885567492,16.319476879962636,19.701074264362447
07020202,07,02,02,02,10310,4474,7654,5836,1818,2656,100.0,43.39476236663434,74.23860329776916,56.60523763336567,17.63336566440349,25.761396702230844
07020203,07,02,02,03,18047,8081,13256,9966,3290,4791,100.0,44.77752535047376,73.45265141020668,55.222474649526234,18.230176760680443,26.54734858979332
07020204,07,02,02,04,12184,4543,9493,7641,1852,2691,100.0,37.28660538411031,77.91365725541694,62.7133946158897,15.200262639527248,22.08634274458306
07030301,07,03,03,01,24833,6862,21083,17971,3112,3750,100.0,27.632585672290904,84.89912616276727,72.3674143277091,12.531711835058188,15.100873837232715
07030302,07,03,03,02,9439,3029,7834,6410,1424,1605,100.0,32.090263799131264,82.99608009323022,67.90973620086874,15.086343892361478,17.003919906769784
07030303,07,03,03,03,12399,5446,9596,6953,2643,2803,100.0,43.92289700782322,77.39333817243326,56.07710299217678,21.316235180256474,22.60666182756674
07040401,07,04,04,01,18738,7757,14396,10981,3415,4342,100.0,41.397160849610415,76.82783648201516,58.602839150389585,18.224997331625573,23.172163517984842
07040402,07,04,04,02,2368,506,2145,1862,283,223,100.0,21.368243243243242,90.58277027027027,78.63175675675676,11.951013513513512,9.41722972972973
07040403,07,04,04,03,24316,9162,19324,15154,4170,4992,100.0,37.6788945550255,79.47030761638428,62.3211054449745,17.149202171409772,20.52969238361573
07040404,07,04,04,04,5196,1372,4544,3824,720,652,100.0,26.40492686682063,87.45188606620478,73.59507313317937,13.856812933025402,12.548113933795227
07040405,07,04,04,05,11060,4757,8420,6303,2117,2640,100.0,43.01084990958409,76.13019891500905,56.98915009041592,19.141048824593128,23.869801084990957
07040406,07,04,04,06,4094,2323,2640,1771,869,1454,100.0,56.74157303370787,64.48461162677089,43.258426966292134,21.22618466047875,35.515388373229115
07050501,07,05,05,01,16725,6737,13192,9988,3204,3533,100.0,40.281016442451424,78.87593423019432,59.718983557548576,19.15695067264574,21.124065769805682
07050502,07,05,05,02,8119,2997,6462,5122,1340,1657,100.0,36.913412981894325,79.59108264564601,63.086587018105675,16.50449562754034,20.408917354353985
07050503,07,05,05,03,9263,3005,7800,6258,1542,1463,100.0,32.440893878872934,84.20598078376335,67.55910612112707,16.646874662636296,15.79401921623664
07050504,07,05,05,04,5652,1816,4832,3836,996,820,100.0,32.13021939136589,85.49186128803963,67.86978060863412,17.62208067940552,14.508138711960367
07050505,07,05,05,05,10673,3107,9209,7566,1643,1464,100.0,29.11084043848965,86.28314438302257,70.88915956151035,15.393984821512227,13.71685561697742
07050506,07,05,05,06,2287,562,2054,1725,329,233,100.0,24.573677306515084,89.81198076082204,75.42632269348492,14.385658067337124,10.188019239177962
07060601,07,06,06,01,10199,4204,7874,5995,1879,2325,100.0,41.21972742425728,77.20364741641338,58.78027257574272,18.423374840670654,22.796352583586625
07060602,07,06,06,02,4703,1108,4239,3595,644,464,100.0,23.55943015096747,90.13395704869232,76.44056984903254,13.693387199659792,9.866042951307676
07060603,07,06,06,03,2861,1067,2377,1794,583,484,100.0,37.29465221950367,83.08283816847256,62.70534778049633,20.377490387976234,16.917161831527437
07060604,07,06,06,04,14592,5523,12445,9069,3376,2147,100.0,37.84950657894737,85.28645833333334,62.15049342105263,23.135964912280702,14.713541666666666
07070701,07,07,07,01,10526,2309,9499,8217,1282,1027,100.0,21.936158084742544,90.24320729621888,78.06384191525746,12.17936538096143,9.756792703781112
07070702,07,07,07,02,10931,2257,10037,8674,1363,894,100.0,20.647699204098437,91.82142530418076,79.35230079590157,12.469124508279206,8.17857469581923
07070703,07,07,07,03,7640,1990,6751,5650,1101,889,100.0,26.04712041884817,88.36387434554975,73.95287958115183,14.410994764397905,11.636125654450263
07070704,07,07,07,04,8547,3368,6663,5179,1484,1884,100.0,39.405639405639405,77.95717795717796,60.594360594360595,17.362817362817363,22.042822042822046
07070705,07,07,07,05,7031,1276,6484,5755,729,547,100.0,18.14820082491822,92.22016782818945,81.85179917508178,10.368368653107666,7.779832171810554
07070706,07,07,07,06,3936,837,3451,3099,352,485,100.0,21.265243902439025,87.6778455284553,78.73475609756098,8.94308943089431,12.322154471544716
07070707,07,07,07,07,2976,491,2735,2485,250,241,100.0,16.498655913978492,91.90188172043011,83.5013440860215,8.400537634408602,8.098118279569892
08010115,08,01,01,15,880,384,649,496,153,231,100.0,43.63636363636363,73.75,56.36363636363636,17.386363636363637,26.25
08010116,08,01,01,16,3697,2129,2268,1568,700,1429,100.0,57.58723289153368,61.34703813903165,42.412767108466326,18.934271030565323,38.652961860968354
08010117,08,01,01,17,16138,8256,10582,7882,2700,5556,100.0,51.15875573181311,65.57194200024786,48.84124426818689,16.730697732060975,34.428057999752134
08010118,08,01,01,18,11891,7206,7465,4685,2780,4426,100.0,60.600454124968465,62.77857202926583,39.399545875031535,23.379026154234296,37.22142797073417
08010211,08,01,02,11,10029,5891,6070,4138,1932,3959,100.0,58.73965500049856,60.52447901086848,41.26034499950145,19.264134011367034,39.47552098913152
08010212,08,01,02,12,7475,5049,4910,2426,2484,2565,100.0,67.54515050167224,65.685618729097,32.45484949832776,33.23076923076923,34.31438127090301
08010213,08,01,02,13,12455,6805,8092,5650,2442,4363,100.0,54.636692091529504,64.96989160979525,45.363307908470496,19.60658370132477,35.03010839020474
08010214,08,01,02,14,8197,4723,5147,3474,1673,3050,100.0,57.618640966207145,62.791265096986706,42.381359033792855,20.40990606319385,37.208734903013294
08010301,08,01,03,01,27732,13599,18984,14133,4851,8748,100.0,49.037213327563826,68.45521419299004,50.96278667243618,17.49242752055387,31.54478580700995
08010302,08,01,03,02,3696,1388,2878,2308,570,818,100.0,37.55411255411256,77.86796536796537,62.44588744588745,15.422077922077923,22.13203463203463
08010303,08,01,03,03,8418,5139,5045,3279,1766,3373,100.0,61.04775481111903,59.93110002375861,38.952245188880966,20.978854834877644,40.06889997624139
08010404,08,01,04,04,23741,12588,15575,11153,4422,8166,100.0,53.02219788551451,65.60380775872963,46.97780211448549,18.626005644244135,34.39619224127037
08010405,08,01,04,05,9049,4262,6257,4787,1470,2792,100.0,47.09912697535639,69.14576196264781,52.9008730246436,16.2448889380042,30.854238037352193
08010406,08,01,04,06,7143,4219,4351,2924,1427,2792,100.0,59.06481870362593,60.912781744365105,40.935181296374076,19.97760044799104,39.08721825563489
08010407,08,01,04,07,799,357,563,442,121,236,100.0,44.680851063829785,70.4630788485607,55.319148936170215,15.143929912390488,29.536921151439298
08010508,08,01,05,08,5772,4158,3770,1614,2156,2002,100.0,72.03742203742203,65.31531531531532,27.96257796257796,37.35273735273735,34.68468468468468
08010509,08,01,05,09,9459,6232,6666,3227,3439,2793,100.0,65.88434295380061,70.47256581033936,34.11565704619939,36.35690876413997,29.52743418966064
08010510,08,01,05,10,480,325,220,155,65,260,100.0,67.70833333333334,45.83333333333333,32.29166666666667,13.541666666666666,54.166666666666664
08020619,08,02,06,19,11646,6503,7619,5143,2476,4027,100.0,55.83891464880646,65.42160398420059,44.16108535119354,21.26051863300704,34.57839601579942
08020620,08,02,06,20,9354,4198,7321,5156,2165,2033,100.0,44.87919606585418,78.26598246739363,55.120803934145826,23.145178533247808,21.734017532606373
08020621,08,02,06,21,2346,615,2155,1731,424,191,100.0,26.214833759590796,91.85848252344417,73.78516624040921,18.073316283034956,8.14151747655584
08020622,08,02,06,22,14211,4071,12292,10140,2152,1919,100.0,28.646822883681654,86.49637604672436,71.35317711631835,15.143198930406024,13.503623953275632
08020623,08,02,06,23,1281,388,1108,893,215,173,100.0,30.288836846213897,86.49492583918813,69.7111631537861,16.783762685402028,13.505074160811867
08020624,08,02,06,24,1410,508,1231,902,329,179,100.0,36.02836879432624,87.30496453900709,63.97163120567376,23.333333333333332,12.695035460992907
08020625,08,02,06,25,3319,988,2797,2331,466,522,100.0,29.76800241036457,84.27237119614341,70.23199758963543,14.040373606507984,15.727628803856582
08020726,08,02,07,26,8403,2148,7492,6255,1237,911,100.0,25.562299178864688,89.15863382125431,74.43770082113531,14.720933000119004,10.841366178745686
08020727,08,02,07,27,12013,3730,10244,8283,1961,1769,100.0,31.049696162490637,85.27428618996088,68.95030383750937,16.32398235245151,14.725713810039123
08020728,08,02,07,28,8851,3852,6852,4999,1853,1999,100.0,43.52050615749633,77.41498135803863,56.47949384250367,20.935487515534966,22.58501864196136
08030829,08,03,08,29,12437,6328,9879,6109,3770,2558,100.0,50.88043740451877,79.43233898850205,49.11956259548123,30.312776393020822,20.56766101149795
08030830,08,03,08,30,7415,3043,6214,4372,1842,1201,100.0,41.03843560350641,83.80310182063386,58.96156439649359,24.841537424140256,16.19689817936615
08030831,08,03,08,31,17564,8959,13912,8605,5307,3652,100.0,51.00774311090868,79.20746982464131,48.99225688909132,30.21521293554999,20.79253017535869
08040932,08,04,09,32,2868,952,2478,1916,562,390,100.0,33.19386331938633,86.40167364016736,66.80613668061368,19.595536959553698,13.598326359832635
08040933,08,04,09,33,4157,1345,3579,2812,767,578,100.0,32.355063747895116,86.0957421217224,67.64493625210488,18.45080586961751,13.904257878277605
08040934,08,04,09,34,2679,847,2335,1832,503,344,100.0,31.61627472937663,87.15938783128033,68.38372527062336,18.77566256065696,12.840612168719673
08041035,08,04,10,35,8239,2765,7073,5474,1599,1166,100.0,33.55989804587936,85.84779706275033,66.44010195412065,19.40769510862969,14.152202937249667
08041036,08,04,10,36,6866,1633,6204,5233,971,662,100.0,23.783862510923388,90.35828721235072,76.2161374890766,14.142149723274105,9.641712787649286
08041037,08,04,10,37,9865,2607,8677,7258,1419,1188,100.0,26.42676127724278,87.95742524075013,73.57323872275721,14.384186517992903,12.042574759249874
08041038,08,04,10,38,7011,1636,6460,5375,1085,551,100.0,23.334759663386105,92.14092140921409,76.66524033661389,15.4756810726002,7.8590785907859075
08041039,08,04,10,39,3870,1122,3497,2748,749,373,100.0,28.992248062015502,90.36175710594316,71.0077519379845,19.354005167958658,9.638242894056848
08041040,08,04,10,40,7930,1922,7165,6008,1157,765,100.0,24.237074401008826,90.3530895334174,75.76292559899117,14.59016393442623,9.646910466582598
09010101,09,01,01,01,12471,3918,10078,8553,1525,2393,100.0,31.41688717825355,80.81148263972416,68.58311282174645,12.228369817977708,19.18851736027584
09010102,09,01,01,02,69,12,60,57,3,9,100.0,17.391304347826086,86.95652173913044,82.6086956521739,4.3478260869565215,13.043478260869565
09010201,09,01,02,01,4341,751,3939,3590,349,402,100.0,17.300161253167474,90.7394609536973,82.69983874683253,8.039622206864777,9.260539046302695
09010202,09,01,02,02,6980,1196,6217,5784,433,763,100.0,17.134670487106018,89.06876790830945,82.86532951289398,6.203438395415473,10.931232091690545
09010301,09,01,03,01,15668,2427,14251,13241,1010,1417,100.0,15.490171049272403,90.95608884350268,84.5098289507276,6.446259892775083,9.04391115649732
09010302,09,01,03,02,2894,679,2614,2215,399,280,100.0,23.46233586731168,90.32480995162405,76.53766413268832,13.787145818935729,9.675190048375951
09010401,09,01,04,01,8503,925,8010,7578,432,493,100.0,10.878513465835587,94.20204633658709,89.12148653416442,5.080559802422675,5.797953663412913
09010402,09,01,04,02,11436,1707,10604,9729,875,832,100.0,14.926547743966424,92.72472892619797,85.07345225603358,7.6512766701643935,7.2752710738020285
09020501,09,02,05,01,7398,2178,5758,5220,538,1640,100.0,29.44038929440389,77.83184644498513,70.55961070559611,7.272235739389024,22.168153555014868
09020502,09,02,05,02,15732,3364,13500,12368,1132,2232,100.0,21.38316806509026,85.81235697940504,78.61683193490974,7.195525044495296,14.187643020594965
09020601,09,02,06,01,8970,2604,6974,6366,608,1996,100.0,29.03010033444816,77.74804905239688,70.96989966555184,6.7781493868450395,22.25195094760312
09020602,09,02,06,02,3587,279,3448,3308,140,139,100.0,7.778087538332869,96.12489545581265,92.22191246166713,3.9029829941455256,3.875104544187343
09020701,09,02,07,01,2763,1147,1876,1616,260,887,100.0,41.512848353239235,67.89721317408613,58.48715164676077,9.410061527325372,32.10278682591386
09020702,09,02,07,02,16805,2750,14929,14055,874,1876,100.0,16.364177328176137,88.83665575721511,83.63582267182387,5.2008330853912526,11.163344242784886
09020801,09,02,08,01,2948,281,2779,2667,112,169,100.0,9.531886024423338,94.2672998643148,90.46811397557666,3.7991858887381276,5.732700135685211
09020802,09,02,08,02,7916,1511,6879,6405,474,1037,100.0,19.087923193532085,86.899949469429,80.91207680646791,5.987872662961092,13.100050530570995
09030901,09,03,09,01,13213,1787,12417,11426,991,796,100.0,13.524559146295315,93.97563006130326,86.47544085370468,7.500189207598577,6.024369938696738
09030902,09,03,09,02,5665,788,5259,4877,382,406,100.0,13.909973521624009,92.83318623124448,86.09002647837599,6.7431597528684915,7.166813768755516
09030903,09,03,09,03,8167,1547,7476,6620,856,691,100.0,18.94208399657157,91.5391208522101,81.05791600342843,10.481204848781681,8.460879147789885
09031001,09,03,10,01,13117,1684,12094,11433,661,1023,100.0,12.838301440878249,92.20096058549973,87.16169855912175,5.039262026377983,7.799039414500267
09031101,09,03,11,01,6530,871,5961,5659,302,569,100.0,13.338437978560492,91.28637059724349,86.66156202143951,4.624808575803982,8.713629402756508
09031201,09,03,12,01,1833,171,1767,1662,105,66,100.0,9.328968903436989,96.39934533551555,90.67103109656301,5.728314238952537,3.600654664484452
09031202,09,03,12,02,2577,269,2435,2308,127,142,100.0,10.43849437330229,94.48971672487389,89.56150562669771,4.928211098176174,5.510283275126115
09041301,09,04,13,01,14701,1338,13903,13363,540,798,100.0,9.101421671995102,94.57179783688184,90.8985783280049,3.6732195088769473,5.428202163118155
09041302,09,04,13,02,1898,188,1813,1710,103,85,100.0,9.905163329820864,95.52160168598525,90.09483667017913,5.426765015806112,4.478398314014752
09041401,09,04,14,01,4833,389,4668,4444,224,165,100.0,8.048830953858886,96.58597144630664,91.95116904614112,4.634802400165529,3.414028553693358
09041402,09,04,14,02,1558,212,1454,1346,108,104,100.0,13.607188703465983,93.32477535301669,86.39281129653402,6.93196405648267,6.675224646983311
09041501,09,04,15,01,7712,1419,6795,6293,502,917,100.0,18.399896265560166,88.1094398340249,81.60010373443983,6.509336099585063,11.890560165975103
09041601,09,04,16,01,6755,497,6543,6258,285,212,100.0,7.357512953367876,96.86158401184308,92.64248704663213,4.219096965210955,3.138415988156921
09051701,09,05,17,01,4052,435,3768,3617,151,284,100.0,10.735439289239881,92.99111549851925,89.26456071076012,3.7265547877591314,7.00888450148075
09051702,09,05,17,02,15002,1238,14407,13764,643,595,100.0,8.252233035595253,96.0338621517131,91.74776696440475,4.286095187308359,3.966137848286895
09051801,09,05,18,01,9477,889,9002,8588,414,475,100.0,9.380605676901974,94.98786535823572,90.61939432309802,4.368471035137702,5.012134641764272
09051901,09,05,19,01,11304,1374,10481,9930,551,823,100.0,12.154989384288747,92.71939136588819,87.84501061571125,4.874380750176929,7.280608634111818
09052001,09,05,20,01,12900,1040,12365,11860,505,535,100.0,8.062015503875969,95.85271317829456,91.93798449612403,3.914728682170543,4.147286821705427
10010101,10,01,01,01,5752,1510,4944,4242,702,808,100.0,26.25173852573018,85.95271210013908,73.74826147426981,12.204450625869264,14.047287899860919
10010102,10,01,01,02,18455,4800,16183,13655,2528,2272,100.0,26.0092115957735,87.68897317800054,73.99078840422649,13.698184773774043,12.311026821999459
10010203,10,01,02,03,1330,865,519,465,54,811,100.0,65.0375939849624,39.02255639097744,34.962406015037594,4.06015037593985,60.97744360902255
10010204,10,01,02,04,10747,2611,9517,8136,1381,1230,100.0,24.29515213547967,88.55494556620452,75.70484786452033,12.85009770168419,11.445054433795478
10010205,10,01,02,05,8172,1290,7485,6882,603,687,100.0,15.7856093979442,91.59324522760646,84.2143906020558,7.3788546255506615,8.406754772393539
10010206,10,01,02,06,17600,4466,14958,13134,1824,2642,100.0,25.374999999999996,84.98863636363636,74.625,10.363636363636363,15.011363636363637
10010207,10,01,02,07,10733,2561,9598,8172,1426,1135,100.0,23.860989471722725,89.42513742662815,76.13901052827727,13.286126898350881,10.574862573371844
10010308,10,01,03,08,2187,593,1825,1594,231,362,100.0,27.114769090077733,83.44764517604024,72.88523090992227,10.562414266117969,16.55235482395976
10010309,10,01,03,09,14391,3312,12999,11079,1920,1392,100.0,23.014383989993746,90.3272878882635,76.98561601000625,13.341671878257245,9.672712111736502
10010310,10,01,03,10,18199,4075,16261,14124,2137,1938,100.0,22.391340183526566,89.35106324523325,77.60865981647343,11.742403428759822,10.648936754766746
10010311,10,01,03,11,3695,524,3507,3171,336,188,100.0,14.181326116373477,94.91204330175913,85.81867388362652,9.093369418132612,5.087956698240866
10020412,10,02,04,12,6835,2035,5735,4800,935,1100,100.0,29.773226042428675,83.9063643013899,70.22677395757133,13.679590343818582,16.093635698610097
10020413,10,02,04,13,16114,3461,13864,12653,1211,2250,100.0,21.47821769889537,86.03698647139134,78.52178230110462,7.515204170286707,13.963013528608665
10020414,10,02,04,14,1676,737,1384,939,445,292,100.0,43.97374701670644,82.57756563245823,56.02625298329356,26.551312649164675,17.42243436754177
10020415,10,02,04,15,5776,1759,4440,4017,423,1336,100.0,30.45360110803324,76.86980609418282,69.54639889196676,7.323407202216066,23.130193905817176
10020416,10,02,04,16,5646,1582,4559,4064,495,1087,100.0,28.019837052780726,80.74743181013106,71.98016294721927,8.767268862911797,19.252568189868935
10020517,10,02,05,17,9213,1351,8380,7862,518,833,100.0,14.66406165201346,90.9584283078259,85.33593834798654,5.622489959839357,9.041571692174102
10020518,10,02,05,18,5314,1029,4636,4285,351,678,100.0,19.363944298080543,87.24124952954459,80.63605570191946,6.605193827625142,12.758750470455402
10020519,10,02,05,19,6105,1825,4879,4280,599,1226,100.0,29.89352989352989,79.91809991809991,70.10647010647011,9.811629811629812,20.08190008190008
10020620,10,02,06,20,3367,575,3092,2792,300,275,100.0,17.077517077517076,91.83249183249184,82.92248292248291,8.91000891000891,8.167508167508169
10020621,10,02,06,21,6329,1259,5562,5070,492,767,100.0,19.892558066045186,87.8811818612735,80.10744193395482,7.773739927318692,12.118818138726498
10020622,10,02,06,22,8634,1172,8113,7462,651,521,100.0,13.574241371322678,93.96571693305536,86.42575862867731,7.5399583043780405,6.034283066944638
10020623,10,02,06,23,6527,812,6183,5715,468,344,100.0,12.440631224145855,94.72958480159338,87.55936877585414,7.170216025739237,5.270415198406619
10030724,10,03,07,24,7871,1363,6995,6508,487,876,100.0,17.316732308474144,88.87053741583027,82.68326769152586,6.187269724304409,11.129462584169737
10030725,10,03,07,25,6311,1320,5516,4991,525,795,100.0,20.915861194739342,87.40294723498653,79.08413880526065,8.318808429725875,12.59705276501347
10030726,10,03,07,26,3497,659,3081,2838,243,416,100.0,18.844724049185015,88.10408921933085,81.15527595081498,6.94881326851587,11.895910780669144
10030727,10,03,07,27,9733,1030,9353,8703,650,380,100.0,10.582554197061542,96.09575670399671,89.41744580293846,6.678310901058255,3.9042432960032873
10040828,10,04,08,28,7805,699,7498,7106,392,307,100.0,8.955797565663035,96.06662395900064,91.04420243433697,5.0224215246636765,3.93337604099936
10040829,10,04,08,29,3923,398,3671,3525,146,252,100.0,10.145296966607189,93.57634463420852,89.85470303339281,3.7216416008157025,6.423655365791486
10040830,10,04,08,30,7646,517,7480,7129,351,166,100.0,6.7617054669108025,97.82893015956056,93.23829453308919,4.590635626471357,2.1710698404394457
10040931,10,04,09,31,9714,821,9376,8893,483,338,100.0,8.451719168210829,96.52048589664402,91.54828083178917,4.972205064854849,3.479514103355981
10040932,10,04,09,32,4273,437,4051,3836,215,222,100.0,10.227006786800843,94.80458694125907,89.77299321319916,5.031593728059911,5.1954130587409315
10040933,10,04,09,33,15169,1060,14773,14109,664,396,100.0,6.987935921946074,97.38941261783901,93.01206407805392,4.377348539785088,2.610587382160986
11010101,11,01,01,01,648,76,599,572,27,49,100.0,11.728395061728394,92.43827160493827,88.27160493827161,4.166666666666666,7.561728395061729
11010102,11,01,01,02,2594,155,2540,2439,101,54,100.0,5.97532767925983,97.9182729375482,94.02467232074017,3.893600616808018,2.081727062451812
11010103,11,01,01,03,1541,380,1251,1161,90,290,100.0,24.659312134977288,81.18105126541208,75.34068786502272,5.840363400389357,18.818948734587927
11010204,11,01,02,04,8928,2651,7385,6277,1108,1543,100.0,29.693100358422942,82.71729390681004,70.30689964157706,12.410394265232975,17.282706093189965
11010205,11,01,02,05,6704,1855,5740,4849,891,964,100.0,27.670047732696894,85.62052505966588,72.3299522673031,13.290572792362768,14.379474940334127
11010206,11,01,02,06,6078,1521,5144,4557,587,934,100.0,25.024679170779862,84.63310299440604,74.97532082922014,9.657782165185916,15.366897005593946
11010207,11,01,02,07,7459,1826,6222,5633,589,1237,100.0,24.480493363721678,83.41600750770881,75.51950663627832,7.8965008714304865,16.58399249229119
11010308,11,01,03,08,11808,3387,9889,8421,1468,1919,100.0,28.683943089430898,83.74830623306234,71.3160569105691,12.432249322493224,16.25169376693767
11010309,11,01,03,09,9715,2633,8142,7082,1060,1573,100.0,27.10241893978384,83.8085434894493,72.89758106021617,10.910962429233145,16.191456510550694
11010310,11,01,03,10,5754,1117,5022,4637,385,732,100.0,19.412582551268684,87.2784150156413,80.58741744873132,6.690997566909976,12.721584984358708
11020411,11,02,04,11,9461,2571,7590,6890,700,1871,100.0,27.17471726033189,80.22407779304514,72.82528273966811,7.398795053377022,19.775922206954867
11020412,11,02,04,12,6827,1461,5961,5366,595,866,100.0,21.40032224989014,87.31507250622528,78.59967775010985,8.715394756115424,12.684927493774717
11020513,11,02,05,13,3964,829,3340,3135,205,624,100.0,20.91321897073663,84.25832492431887,79.08678102926338,5.1715438950555,15.74167507568113
11020514,11,02,05,14,9628,2297,7866,7331,535,1762,100.0,23.85749896136269,81.69921063564604,76.1425010386373,5.556709597008725,18.300789364353967
11020515,11,02,05,15,14813,3833,12580,10980,1600,2233,100.0,25.875919800175524,84.92540336191183,74.12408019982448,10.801323162087357,15.074596638088167
11020516,11,02,05,16,4033,661,3717,3372,345,316,100.0,16.389784279692538,92.16464170592612,83.61021572030747,8.554425985618646,7.835358294073891
11030617,11,03,06,17,6310,2234,4892,4076,816,1418,100.0,35.4041204437401,77.52773375594295,64.5958795562599,12.931854199683043,22.472266244057053
11030618,11,03,06,18,16424,4489,13733,11935,1798,2691,100.0,27.331953239162203,83.61544081831465,72.6680467608378,10.947394057476863,16.384559181685336
11030619,11,03,06,19,11012,3489,8952,7523,1429,2060,100.0,31.683617871413006,81.29313476207773,68.316382128587,12.976752633490737,18.706865237922266
11030720,11,03,07,20,5732,3514,2547,2218,329,3185,100.0,61.3049546406141,44.434752267969294,38.6950453593859,5.739706908583392,55.56524773203071
11030721,11,03,07,21,25075,6579,20546,18496,2050,4529,100.0,26.23728813559322,81.938185443669,73.76271186440678,8.175473579262214,18.061814556331008
11030824,11,03,08,24,10084,3620,7843,6464,1379,2241,100.0,35.89845299484332,77.77667592225306,64.10154700515669,13.67512891709639,22.223324077746927
11040925,11,04,09,25,4214,962,3590,3252,338,624,100.0,22.828666350261035,85.1922164214523,77.17133364973895,8.020882771713337,14.807783578547697
11040926,11,04,09,26,29258,6415,24970,22843,2127,4288,100.0,21.925627178891244,85.34417936974504,78.07437282110877,7.269806548636271,14.655820630254974
11041022,11,04,10,22,5507,1882,4162,3625,537,1345,100.0,34.17468676230253,75.57653895042674,65.82531323769749,9.751225712729255,24.42346104957327
11041023,11,04,10,23,6692,2250,5399,4442,957,1293,100.0,33.622235505080695,80.67842199641363,66.3777644949193,14.300657501494321,19.32157800358637
11041027,11,04,10,27,3022,809,2524,2213,311,498,100.0,26.770350761085375,83.52084712111186,73.22964923891463,10.29119788219722,16.479152878888154
11041128,11,04,11,28,25613,6141,22002,19472,2530,3611,100.0,23.976105883730916,85.90169054776872,76.02389411626909,9.877796431499629,14.09830945223129
11051229,11,05,12,29,4216,868,3706,3348,358,510,100.0,20.588235294117645,87.90322580645162,79.41176470588235,8.49146110056926,12.096774193548388
11051330,11,05,13,30,9821,1923,8482,7898,584,1339,100.0,19.580490785052437,86.36595051420426,80.41950921494757,5.946441299256695,13.634049485795744
11051331,11,05,13,31,10540,1270,9911,9270,641,629,100.0,12.04933586337761,94.03225806451613,87.9506641366224,6.081593927893738,5.967741935483871
11051332,11,05,13,32,7018,917,6575,6101,474,443,100.0,13.066400683955543,93.68766030208036,86.93359931604445,6.754060986035908,6.312339697919635
12103115,12,10,31,15,7749,3287,5896,4462,1434,1853,100.0,42.41837656471803,76.08723706284682,57.58162343528197,18.505613627564845,23.912762937153182
12103116,12,10,31,16,9871,4648,7089,5223,1866,2782,100.0,47.08742781886334,71.81643197244453,52.91257218113666,18.903859791307873,28.183568027555467
12103117,12,10,31,17,10930,5771,7457,5159,2298,3473,100.0,52.7996340347667,68.22506861848125,47.2003659652333,21.024702653247942,31.774931381518755
12103218,12,10,32,18,13835,5989,10541,7846,2695,3294,100.0,43.288760390314415,76.19082038308638,56.711239609685585,19.479580773400794,23.809179616913624
12103219,12,10,32,19,8778,3876,6678,4902,1776,2100,100.0,44.15584415584416,76.07655502392345,55.84415584415584,20.2323991797676,23.923444976076556
12103220,12,10,32,20,4633,1358,3920,3275,645,713,100.0,29.311461256205483,84.61040362616016,70.68853874379451,13.921864882365636,15.389596373839845
12214125,12,21,41,25,7497,2311,6270,5186,1084,1227,100.0,30.82566359877284,83.63345338135254,69.17433640122715,14.459116980125383,16.366546618647458
12214126,12,21,41,26,8106,3155,6470,4951,1519,1636,100.0,38.921786331112756,79.81741919565754,61.07821366888725,18.739205526770295,20.18258080434246
12214421,12,21,44,21,2747,1023,2124,1724,400,623,100.0,37.24062613760466,77.32071350564253,62.75937386239534,14.561339643247178,22.67928649435748
12214422,12,21,44,22,8224,4796,5490,3428,2062,2734,100.0,58.3171206225681,66.75583657587548,41.68287937743191,25.07295719844358,33.244163424124515
12214423,12,21,44,23,5694,2326,4510,3368,1142,1184,100.0,40.85001756234633,79.20618194590797,59.14998243765367,20.056199508254302,20.793818054092025
12214424,12,21,44,24,10833,5484,7457,5349,2108,3376,100.0,50.62309609526447,68.83596418351334,49.37690390473553,19.45906027877781,31.164035816486663
12214527,12,21,45,27,10911,2415,9558,8496,1062,1353,100.0,22.133626615342315,87.5996700577399,77.86637338465768,9.73329667308221,12.400329942260106
12214528,12,21,45,28,256,98,191,158,33,65,100.0,38.28125,74.609375,61.71875,12.890625,25.390625
12224229,12,22,42,29,6026,826,5704,5200,504,322,100.0,13.707268503153003,94.65648854961832,86.292731496847,8.363757052771325,5.343511450381679
12224230,12,22,42,30,18072,2409,17110,15663,1447,962,100.0,13.330013280212484,94.67684816290394,86.66998671978752,8.006861443116422,5.32315183709606
12231101,12,23,11,01,16643,2329,15547,14314,1233,1096,100.0,13.993871297242084,93.41464880129784,86.0061287027579,7.408520098539927,6.585351198702156
12231102,12,23,11,02,16828,2178,15938,14650,1288,890,100.0,12.94271452341336,94.71119562633706,87.05728547658664,7.653910149750416,5.288804373662943
12301203,12,30,12,03,15084,4560,12255,10524,1731,2829,100.0,30.23070803500398,81.24502784407319,69.76929196499603,11.475735879077167,18.75497215592681
12301204,12,30,12,04,6229,1403,5595,4826,769,634,100.0,22.5236795633328,89.82180125220741,77.4763204366672,12.345480815540215,10.178198747792583
12301205,12,30,12,05,5005,926,4596,4079,517,409,100.0,18.5014985014985,91.82817182817182,81.4985014985015,10.329670329670328,8.171828171828171
12301206,12,30,12,06,5185,841,4886,4344,542,299,100.0,16.219864995178398,94.23336547733847,83.7801350048216,10.453230472516875,5.766634522661524
12302107,12,30,21,07,3071,1297,2517,1774,743,554,100.0,42.233800065125365,81.96027352653859,57.76619993487463,24.194073591663955,18.03972647346141
12302108,12,30,21,08,14578,6226,11640,8352,3288,2938,100.0,42.70819042392646,79.84634380573466,57.29180957607354,22.554534229661133,20.15365619426533
12302109,12,30,21,09,11691,5987,8726,5704,3022,2965,100.0,51.21033273458215,74.6386108972714,48.78966726541784,25.84894363185356,25.361389102728594
12302110,12,30,21,10,10574,5832,7560,4742,2818,3014,100.0,55.154151692831476,71.49612256478154,44.84584830716853,26.65027425761301,28.50387743521846
12302211,12,30,22,11,3339,950,2919,2389,530,420,100.0,28.451632225217132,87.42138364779875,71.54836777478288,15.873015873015872,12.578616352201259
12302212,12,30,22,12,5964,2837,4186,3127,1059,1778,100.0,47.56874580818243,70.18779342723005,52.431254191817565,17.756539235412475,29.812206572769952
12304313,12,30,43,13,6735,1613,5726,5122,604,1009,100.0,23.94951744617669,85.01855976243505,76.0504825538233,8.96807720861173,14.981440237564957
12304314,12,30,43,14,9738,1429,9053,8309,744,685,100.0,14.674471143972067,92.96570137605258,85.32552885602793,7.640172520024646,7.034298623947423
