id,district_id,forecast_area_id,district_region_id,planning_area_id,inhabitants,inhabitants_with_migration_background,inhabitants_germans,inhabitants_germans_without_migration_background,inhabitants_germans_with_migration_background,inhabitants_foreigners,inhabitants_percentage,inhabitants_with_migration_background_percentage,inhabitants_germans_percentage,inhabitants_germans_without_migration_background_percentage,inhabitants_germans_with_migration_background_percentage,inhabitants_foreigners_percentage
01100101,01,10,01,01,3580,2404,1999,1176,823,1581,100.0,67.15083798882682,55.837988826815646,32.849162011173185,22.988826815642458,44.162011173184354
01100102,01,10,01,02,2034,1438,941,596,345,1093,100.0,70.69813176007867,46.263520157325466,29.301868239921337,16.96165191740413,53.736479842674534
01100103,01,10,01,03,5790,3594,3588,2196,1392,2202,100.0,62.072538860103634,61.968911917098445,37.92746113989637,24.041450777202073,38.031088082901555
01100104,01,10,01,04,4889,3252,2929,1637,1292,1960,100.0,66.5166700756801,59.91000204540806,33.483329924319904,26.426672121088156,40.089997954591944
01100205,01,10,02,05,2917,2033,1389,884,505,1528,100.0,69.69489201234144,47.617415152553995,30.305107987658552,17.31230716489544,52.382584847446
01100206,01,10,02,06,1876,1027,1202,849,353,674,100.0,54.74413646055437,64.0724946695096,45.25586353944563,18.816631130063964,35.927505330490405
01100207,01,10,02,07,8844,5089,5587,3755,1832,3257,100.0,57.541836273179555,63.172772501130716,42.458163726820445,20.714608774310268,36.82722749886929
01100308,01,10,03,08,7297,3650,4795,3647,1148,2502,100.0,50.02055639303824,65.7119364122242,49.979443606961766,15.732492805262439,34.288063587775795
01100309,01,10,03,09,12651,5700,8991,6951,2040,3660,100.0,45.05572682001423,71.06948067346454,54.94427317998577,16.125207493478776,28.930519326535453
01100310,01,10,03,10,10181,5618,6304,4563,1741,3877,100.0,55.18121991945782,61.91926136921717,44.81878008054218,17.10048128867498,38.08073863078283
01100311,01,10,03,11,9787,5368,6332,4419,1913,3455,100.0,54.84826811075917,64.6980688668642,45.15173188924083,19.546336977623376,35.301931133135795
01100312,01,10,03,12,10727,5681,6943,5046,1897,3784,100.0,52.95982101239862,64.72452689475156,47.04017898760138,17.684347907150183,35.27547310524844
01100313,01,10,03,13,11590,6059,7406,5531,1875,4184,100.0,52.27782571182053,63.899913718723035,47.72217428817947,16.17773943054357,36.10008628127696
01100414,01,10,04,14,5513,3289,3091,2224,867,2422,100.0,59.65898784690731,56.067476872846,40.34101215309269,15.726464719753311,43.932523127154
01100415,01,10,04,15,13348,6171,9185,7177,2008,4163,100.0,46.231645190290685,68.81180701228648,53.768354809709315,15.043452202577164,31.188192987713514
01100416,01,10,04,16,13523,6048,9591,7475,2116,3932,100.0,44.72380388966945,70.9236116246395,55.276196110330545,15.647415514308955,29.076388375360494
01200517,01,20,05,17,3924,2489,2157,1435,722,1767,100.0,63.430173292558614,54.96941896024465,36.569826707441386,18.399592252803263,45.030581039755354
01200518,01,20,05,18,7096,4742,3826,2354,1472,3270,100.0,66.82638105975197,53.917700112739574,33.173618940248026,20.744081172491544,46.08229988726043
01200519,01,20,05,19,9592,5611,5761,3981,1780,3831,100.0,58.496663886572144,60.0604670558799,41.503336113427856,18.557130942452044,39.939532944120096
01200520,01,20,05,20,9513,4841,6524,4672,1852,2989,100.0,50.88825817302638,68.57983811626195,49.11174182697361,19.468096289288344,31.42016188373804
01200521,01,20,05,21,5259,3289,3133,1970,1163,2126,100.0,62.54040692146796,59.57406351017303,37.45959307853204,22.114470431640996,40.42593648982697
01200522,01,20,05,22,11521,4558,8898,6963,1935,2623,100.0,39.56253797413419,77.23287909035675,60.437462025865806,16.79541706449093,22.76712090964326
01200623,01,20,06,23,10990,6023,7259,4967,2292,3731,100.0,54.804367606915385,66.05095541401273,45.19563239308462,20.855323020928115,33.94904458598726
01200624,01,20,06,24,6942,5139,3349,1803,1546,3593,100.0,74.0276577355229,48.2425813886488,25.972342264477096,22.27023912417171,51.75741861135119
01200625,01,20,06,25,6905,4293,4464,2612,1852,2441,100.0,62.17233888486604,64.64880521361333,37.82766111513396,26.821144098479362,35.35119478638668
01200626,01,20,06,26,6079,2856,4307,3223,1084,1772,100.0,46.98141141635138,70.85046882710972,53.01858858364863,17.831880243461097,29.14953117289028
01200627,01,20,06,27,3388,2328,2193,1060,1133,1195,100.0,68.71310507674144,64.728453364817,31.286894923258558,33.44155844155844,35.271546635183
01200628,01,20,06,28,3281,1573,2395,1708,687,886,100.0,47.942700396220665,72.99603779335568,52.05729960377934,20.93873818957635,27.003962206644317
01200629,01,20,06,29,6039,3084,3921,2955,966,2118,100.0,51.06805762543467,64.92796820665673,48.931942374565324,15.996025832091407,35.072031793343264
01300730,01,30,07,30,8060,5901,4092,2159,1933,3968,100.0,73.21339950372209,50.76923076923077,26.786600496277917,23.982630272952854,49.23076923076923
01300731,01,30,07,31,8922,5654,5177,3268,1909,3745,100.0,63.37144138085631,58.02510647836808,36.62855861914369,21.396547859224388,41.97489352163192
01300732,01,30,07,32,10078,6403,6003,3675,2328,4075,100.0,63.53443143480849,59.56538995832506,36.46556856519151,23.099821393133556,40.43461004167494
01300733,01,30,07,33,11684,7508,7042,4176,2866,4642,100.0,64.25881547415268,60.27045532351934,35.741184525847316,24.52927079767203,39.72954467648066
01300834,01,30,08,34,14258,9698,9793,4560,5233,4465,100.0,68.01795483237481,68.68424744003366,31.982045167625195,36.70220227240847,31.315752559966338
01300835,01,30,08,35,10821,6823,7180,3998,3182,3641,100.0,63.05332224378524,66.35246280380741,36.94667775621477,29.40578504759264,33.64753719619259
01300836,01,30,08,36,14947,10137,8583,4810,3773,6364,100.0,67.81962935706161,57.42289422626614,32.180370642938385,25.24252358332776,42.57710577373386
01400937,01,40,09,37,10966,6004,7206,4962,2244,3760,100.0,54.75104869596936,65.71220134962613,45.24895130403064,20.463250045595476,34.28779865037389
01400938,01,40,09,38,9681,5386,6229,4295,1934,3452,100.0,55.634748476397064,64.34252659849189,44.365251523602936,19.977275074888958,35.65747340150811
01400939,01,40,09,39,6149,3572,3620,2577,1043,2529,100.0,58.09074646283948,58.871361196942594,41.90925353716051,16.962107659782077,41.12863880305741
01400940,01,40,09,40,7094,3092,5677,4002,1675,1417,100.0,43.5861291232027,80.025373555117,56.41387087679729,23.611502678319706,19.974626444883
01400941,01,40,09,41,3863,1952,2753,1911,842,1110,100.0,50.53067564069376,71.26585555267927,49.469324359306235,21.796531193373024,28.734144447320737
01400942,01,40,09,42,8789,5053,5337,3736,1601,3452,100.0,57.492319945386285,60.72363181249288,42.50768005461372,18.215951757879168,39.27636818750711
01401043,01,40,10,43,7627,5264,4390,2363,2027,3237,100.0,69.01796250163892,57.55867313491543,30.982037498361088,26.576635636554347,42.44132686508457
01401044,01,40,10,44,10226,7225,5590,3001,2589,4636,100.0,70.6532368472521,54.66458048112655,29.346763152747897,25.317817328378645,45.33541951887346
01401045,01,40,10,45,5531,4110,3050,1421,1629,2481,100.0,74.30844331947206,55.14373531007051,25.69155668052793,29.45217862954258,44.85626468992949
01401046,01,40,10,46,8869,4778,5731,4091,1640,3138,100.0,53.87304092907882,64.6183335212538,46.12695907092119,18.49137445033262,35.38166647874619
01401047,01,40,10,47,8206,5867,3907,2339,1568,4299,100.0,71.49646600048744,47.61150377772362,28.503533999512555,19.107969778211064,52.38849622227638
01401048,01,40,10,48,9520,6093,5439,3427,2012,4081,100.0,64.00210084033613,57.132352941176464,35.997899159663866,21.134453781512605,42.86764705882353
01401049,01,40,10,49,6637,4194,3794,2443,1351,2843,100.0,63.191200843754714,57.16438149766461,36.80879915624529,20.355582341419314,42.83561850233539
02100101,02,10,01,01,7225,5489,3596,1736,1860,3629,100.0,75.97231833910034,49.77162629757785,24.027681660899656,25.7439446366782,50.22837370242215
02100102,02,10,01,02,8660,6274,5460,2386,3074,3200,100.0,72.44803695150117,63.04849884526559,27.551963048498845,35.49653579676674,36.95150115473441
02100103,02,10,01,03,5470,3550,3669,1920,1749,1801,100.0,64.89945155393053,67.07495429616088,35.10054844606947,31.974405850091408,32.925045703839125
02100104,02,10,01,04,5550,3916,3443,1634,1809,2107,100.0,70.55855855855856,62.03603603603604,29.44144144144144,32.5945945945946,37.96396396396396
02100105,02,10,01,05,9263,6743,5930,2520,3410,3333,100.0,72.79499082370722,64.0181366727842,27.205009176292776,36.81312749649142,35.981863327215805
02100106,02,10,01,06,4813,3173,3250,1640,1610,1563,100.0,65.92561811759818,67.52545190110119,34.07438188240183,33.451070018699355,32.474548098898815
02200207,02,20,02,07,2666,1275,1867,1391,476,799,100.0,47.82445611402851,70.03000750187547,52.1755438859715,17.854463615903978,29.969992498124533
02200208,02,20,02,08,5745,2731,4018,3014,1004,1727,100.0,47.53698868581375,69.93907745865971,52.46301131418625,17.476066144473453,30.060922541340297
02200209,02,20,02,09,10957,4773,8147,6184,1963,2810,100.0,43.56119375741535,74.35429405859269,56.43880624258465,17.91548781600803,25.64570594140732
02200210,02,20,02,10,12350,5880,8696,6470,2226,3654,100.0,47.611336032388664,70.41295546558705,52.388663967611336,18.02429149797571,29.587044534412954
02200211,02,20,02,11,14595,6493,10817,8102,2715,3778,100.0,44.48783830078794,74.11442274751627,55.51216169921206,18.602261048304214,25.885577252483728
02200212,02,20,02,12,8340,4262,6120,4078,2042,2220,100.0,51.1031175059952,73.38129496402878,48.89688249400479,24.48441247002398,26.618705035971225
02200213,02,20,02,13,10004,4674,7065,5330,1735,2939,100.0,46.72131147540984,70.62175129948021,53.278688524590166,17.343062774890043,29.378248700519794
02300314,02,30,03,14,7085,4275,4586,2810,1776,2499,100.0,60.33874382498235,64.72829922371207,39.66125617501765,25.067043048694426,35.271700776287936
02300315,02,30,03,15,8209,4755,5398,3454,1944,2811,100.0,57.92422950420271,65.75709587038617,42.07577049579729,23.681325374588866,34.24290412961384
02300316,02,30,03,16,4160,2121,2940,2039,901,1220,100.0,50.98557692307693,70.67307692307693,49.01442307692307,21.658653846153847,29.326923076923077
02300417,02,30,04,17,8301,4653,5417,3648,1769,2884,100.0,56.05348753162269,65.25719792796049,43.9465124683773,21.310685459583183,34.74280207203952
02300418,02,30,04,18,7629,3838,5231,3791,1440,2398,100.0,50.3080351291126,68.56730895268056,49.6919648708874,18.87534408179316,31.432691047319437
02300419,02,30,04,19,10396,5503,6880,4893,1987,3516,100.0,52.93382070026933,66.17929973066565,47.06617929973066,19.113120430934973,33.82070026933436
02400520,02,40,05,20,5904,2540,4396,3364,1032,1508,100.0,43.02168021680217,74.45799457994579,56.978319783197826,17.479674796747968,25.5420054200542
02400521,02,40,05,21,8712,3801,6287,4911,1376,2425,100.0,43.629476584022036,72.16483011937558,56.37052341597796,15.794306703397613,27.835169880624427
02400522,02,40,05,22,11394,4102,8844,7292,1552,2550,100.0,36.00140424784974,77.6197998946814,63.99859575215026,13.621204142531157,22.38020010531859
02400623,02,40,06,23,14037,7584,9127,6453,2674,4910,100.0,54.02863859799102,65.02101588658546,45.971361402008974,19.049654484576475,34.97898411341455
02400624,02,40,06,24,11887,5000,8241,6887,1354,3646,100.0,42.062757634390515,69.32783713300243,57.937242365609485,11.390594767392951,30.67216286699756
02400625,02,40,06,25,1328,947,565,381,184,763,100.0,71.31024096385542,42.545180722891565,28.68975903614458,13.855421686746988,57.454819277108435
02500726,02,50,07,26,9175,3784,6572,5391,1181,2603,100.0,41.2425068119891,71.62942779291554,58.7574931880109,12.871934604904634,28.37057220708447
02500727,02,50,07,27,6519,2690,4726,3829,897,1793,100.0,41.26399754563583,72.4957815615892,58.73600245436417,13.759779107225034,27.5042184384108
02500728,02,50,07,28,10073,3849,7429,6224,1205,2644,100.0,38.21105926734836,73.75161322346868,61.78894073265164,11.962672490817036,26.248386776531323
02500729,02,50,07,29,5407,2096,4110,3311,799,1297,100.0,38.76456445348622,76.01257628999446,61.235435546513784,14.777140743480674,23.987423710005547
02500830,02,50,08,30,4071,1825,2789,2246,543,1282,100.0,44.82928027511668,68.50896585605503,55.17071972488332,13.338246131171703,31.49103414394498
02500831,02,50,08,31,7857,3475,5436,4382,1054,2421,100.0,44.22807687412498,69.18671248568155,55.77192312587501,13.414789359806543,30.813287514318443
02500832,02,50,08,32,9541,4670,6263,4871,1392,3278,100.0,48.946651294413584,65.64301435908185,51.05334870558642,14.58966565349544,34.35698564091814
02500833,02,50,08,33,10045,4287,6885,5758,1127,3160,100.0,42.67794922847188,68.54156296665008,57.32205077152812,11.219512195121952,31.458437033349924
02500834,02,50,08,34,11299,4374,8334,6925,1409,2965,100.0,38.711390388529956,73.7587397114789,61.288609611470044,12.47013010000885,26.241260288521108
02500835,02,50,08,35,8820,4318,5677,4502,1175,3143,100.0,48.95691609977324,64.36507936507937,51.04308390022676,13.321995464852607,35.63492063492063
02500836,02,50,08,36,5137,1454,4421,3683,738,716,100.0,28.304457854779052,86.0619038349231,71.69554214522094,14.366361689702162,13.938096165076894
03100101,03,10,01,01,4720,1011,4069,3709,360,651,100.0,21.41949152542373,86.20762711864407,78.58050847457628,7.627118644067797,13.792372881355933
03100102,03,10,01,02,3505,1312,2511,2193,318,994,100.0,37.43223965763195,71.64051355206847,62.567760342368054,9.072753209700428,28.359486447931527
03100103,03,10,01,03,9449,2654,7371,6795,576,2078,100.0,28.087628320457192,78.0082548417822,71.91237167954282,6.0958831622393905,21.991745158217803
03200204,03,20,02,04,2423,533,1990,1890,100,433,100.0,21.997523730912093,82.1295914156005,78.00247626908791,4.127115146512588,17.870408584399506
03200205,03,20,02,05,9167,2183,7759,6984,775,1408,100.0,23.81367950256354,84.64055852514454,76.18632049743645,8.454238027708083,15.359441474855458
03200206,03,20,02,06,6842,1810,5585,5032,553,1257,100.0,26.454253142356038,81.62817889505992,73.54574685764396,8.082432037415959,18.371821104940075
03200207,03,20,02,07,11799,2825,10067,8974,1093,1732,100.0,23.942707009068563,85.32078989744893,76.05729299093143,9.263496906517501,14.679210102551062
03200308,03,20,03,08,5261,917,4825,4344,481,436,100.0,17.430146360007605,91.71260216688843,82.5698536399924,9.142748526896028,8.287397833111577
03200309,03,20,03,09,5484,1172,4833,4312,521,651,100.0,21.37126185266229,88.12910284463895,78.62873814733771,9.50036469730124,11.87089715536105
03200310,03,20,03,10,8088,1622,7310,6466,844,778,100.0,20.054401582591495,90.38081107814045,79.9455984174085,10.435212660731949,9.619188921859545
03300411,03,30,04,11,11764,3187,9736,8577,1159,2028,100.0,27.091125467528055,82.76096565793948,72.90887453247194,9.852091125467528,17.239034342060524
03300412,03,30,04,12,5226,732,4875,4494,381,351,100.0,14.006888633754306,93.28358208955224,85.99311136624569,7.290470723306544,6.7164179104477615
03300413,03,30,04,13,3195,358,3032,2837,195,163,100.0,11.205007824726135,94.89827856025039,88.79499217527386,6.103286384976526,5.101721439749609
03300514,03,30,05,14,6869,837,6379,6032,347,490,100.0,12.18517979327413,92.86650167418838,87.81482020672587,5.051681467462513,7.133498325811617
03300515,03,30,05,15,49,6,43,43,0,6,100.0,12.244897959183673,87.75510204081633,87.75510204081633,0.0,12.244897959183673
03300516,03,30,05,16,9560,3255,7168,6305,863,2392,100.0,34.04811715481171,74.97907949790795,65.95188284518828,9.027196652719665,25.020920502092046
03300517,03,30,05,17,1088,59,1060,1029,31,28,100.0,5.422794117647059,97.42647058823529,94.57720588235294,2.849264705882353,2.5735294117647056
03400618,03,40,06,18,4783,1175,4347,3608,739,436,100.0,24.56617185866611,90.88438218691198,75.43382814133389,15.450554045578087,9.11561781308802
03400619,03,40,06,19,10596,2556,9248,8040,1208,1348,100.0,24.122310305775766,87.27821819554549,75.87768969422424,11.400528501321253,12.72178180445451
03400620,03,40,06,20,3506,830,3069,2676,393,437,100.0,23.67370222475756,87.53565316600114,76.32629777524245,11.209355390758699,12.464346833998858
03400721,03,40,07,21,11895,3152,10099,8743,1356,1796,100.0,26.49852879361076,84.90121899957965,73.50147120638924,11.399747793190416,15.098781000420344
03400722,03,40,07,22,3807,900,3281,2907,374,526,100.0,23.64066193853428,86.18334646703441,76.35933806146572,9.824008405568689,13.816653532965589
03400723,03,40,07,23,7507,2164,6223,5343,880,1284,100.0,28.826428666577858,82.89596376715066,71.17357133342213,11.72239243372852,17.10403623284934
03400724,03,40,07,24,8494,1861,7403,6633,770,1091,100.0,21.909583235224865,87.1556392747822,78.09041676477514,9.065222510007063,12.844360725217802
03400725,03,40,07,25,7645,1310,6929,6335,594,716,100.0,17.1353826030085,90.63440156965336,82.8646173969915,7.76978417266187,9.365598430346632
03400826,03,40,08,26,7222,1924,5850,5298,552,1372,100.0,26.64081971752977,81.00249238438106,73.35918028247022,7.643312101910828,18.997507615618943
03400827,03,40,08,27,9703,2793,7924,6910,1014,1779,100.0,28.78491188292281,81.66546428939503,71.2150881170772,10.450376172317839,18.334535710604968
03400828,03,40,08,28,4934,1530,3865,3404,461,1069,100.0,31.00932306445075,78.33400891771383,68.99067693554926,9.343331982164573,21.665991082286176
03400829,03,40,08,29,5968,1571,4895,4397,498,1073,100.0,26.323726541554958,82.02077747989276,73.67627345844504,8.34450402144772,17.97922252010724
03400830,03,40,08,30,9293,2025,8008,7268,740,1285,100.0,21.79059507155924,86.17238781878834,78.20940492844076,7.962982890347574,13.827612181211665
03400831,03,40,08,31,0,0,0,0,0,0,0.0,0.0,0.0,0.0,0.0,0.0
03500932,03,50,09,32,6659,2295,4811,4364,447,1848,100.0,34.4646343294789,72.2480852980928,65.53536567052109,6.712719627571707,27.751914701907193
03500933,03,50,09,33,7686,1824,6488,5862,626,1198,100.0,23.73145979703357,84.41321883944835,76.26854020296643,8.144678636481915,15.586781160551652
03500934,03,50,09,34,10363,3480,8012,6883,1129,2351,100.0,33.581009360223874,77.3135192511821,66.41899063977613,10.894528611405963,22.68648074881791
03500935,03,50,09,35,6799,2165,5330,4634,696,1469,100.0,31.842918076187676,78.39388145315488,68.15708192381233,10.236799529342552,21.606118546845124
03500936,03,50,09,36,10052,2717,8291,7335,956,1761,100.0,27.029446876243533,82.48109828889774,72.97055312375646,9.510545165141265,17.51890171110227
03501037,03,50,10,37,8487,2144,6962,6343,619,1525,100.0,25.262165665134912,82.03134205255095,74.73783433486508,7.2935077176858725,17.96865794744904
03501038,03,50,10,38,7506,1630,6396,5876,520,1110,100.0,21.715960564881428,85.21183053557154,78.28403943511857,6.92779110045297,14.788169464428458
03601139,03,60,11,39,4040,1697,2889,2343,546,1151,100.0,42.004950495049506,71.50990099009901,57.995049504950494,13.514851485148515,28.490099009900987
03601140,03,60,11,40,6016,2248,4466,3768,698,1550,100.0,37.36702127659575,74.23537234042553,62.63297872340425,11.602393617021276,25.76462765957447
03601141,03,60,11,41,7057,2841,5090,4216,874,1967,100.0,40.257899957489016,72.12696613291767,59.742100042510984,12.384866090406689,27.87303386708233
03601142,03,60,11,42,10860,4343,7917,6517,1400,2943,100.0,39.99079189686924,72.90055248618785,60.00920810313075,12.89134438305709,27.09944751381215
03601243,03,60,12,43,6990,2339,5514,4651,863,1476,100.0,33.4620886981402,78.88412017167383,66.5379113018598,12.346208869814019,21.115879828326182
03601244,03,60,12,44,7614,2388,6077,5226,851,1537,100.0,31.36327817178881,79.81350144470711,68.6367218282112,11.176779616495928,20.186498555292882
03601245,03,60,12,45,13511,4759,10289,8752,1537,3222,100.0,35.22315150618015,76.15276441418104,64.77684849381986,11.375915920361187,23.847235585818964
03601346,03,60,13,46,5888,2318,4319,3570,749,1569,100.0,39.36820652173913,73.35258152173914,60.63179347826087,12.720788043478262,26.64741847826087
03601347,03,60,13,47,9495,3371,7346,6124,1222,2149,100.0,35.502896261190095,77.36703528172723,64.4971037388099,12.869931542917326,22.632964718272774
03601348,03,60,13,48,7470,2739,5704,4731,973,1766,100.0,36.666666666666664,76.35876840696118,63.33333333333333,13.025435073627845,23.64123159303882
03601449,03,60,14,49,9928,2478,8359,7450,909,1569,100.0,24.959709911361806,84.19621273166801,75.0402900886382,9.155922643029815,15.80378726833199
03601450,03,60,14,50,5449,3417,2404,2032,372,3045,100.0,62.70875389979813,44.11818682327032,37.29124610020187,6.826940723068454,55.88181317672968
03601451,03,60,14,51,6527,2384,4875,4143,732,1652,100.0,36.525203002910985,74.68975026811705,63.47479699708901,11.214953271028037,25.31024973188295
03601452,03,60,14,52,4746,2092,3291,2654,637,1455,100.0,44.07922461019806,69.34260429835652,55.92077538980193,13.421828908554573,30.65739570164349
03601453,03,60,14,53,3391,1325,2579,2066,513,812,100.0,39.07401946328516,76.05426127985845,60.92598053671483,15.128280743143616,23.945738720141552
03701554,03,70,15,54,11453,4843,8246,6610,1636,3207,100.0,42.28586396577316,71.99860298611718,57.71413603422684,14.284466951890334,28.001397013882823
03701555,03,70,15,55,7258,2654,5553,4604,949,1705,100.0,36.56654725819785,76.50868007715624,63.43345274180216,13.075227335354093,23.491319922843758
03701556,03,70,15,56,8598,3638,6184,4960,1224,2414,100.0,42.31216561991161,71.92370318678762,57.68783438008839,14.235868806699232,28.076296813212377
03701657,03,70,16,57,3215,1144,2492,2071,421,723,100.0,35.58320373250389,77.51166407465007,64.41679626749611,13.094867807153964,22.488335925349922
03701658,03,70,16,58,8285,3038,6304,5247,1057,1981,100.0,36.66867833433917,76.08931804465902,63.33132166566083,12.75799637899819,23.91068195534098
03701659,03,70,16,59,9477,3818,6972,5659,1313,2505,100.0,40.28701065738103,73.56758467869578,59.71298934261897,13.854595336076816,26.43241532130421
03701660,03,70,16,60,12614,3965,10191,8649,1542,2423,100.0,31.43332804820041,80.79118439828761,68.56667195179959,12.22451244648803,19.208815601712384
04100101,04,10,01,01,11768,6552,7711,5216,2495,4057,100.0,55.67641060503059,65.525152957172,44.32358939496941,21.201563562202583,34.47484704282801
04100102,04,10,01,02,7878,4770,5459,3108,2351,2419,100.0,60.54836252856055,69.2942371160193,39.45163747143945,29.842599644579842,30.705762883980707
04200203,04,20,02,03,1456,421,1216,1035,181,240,100.0,28.914835164835168,83.51648351648352,71.08516483516483,12.431318681318682,16.483516483516482
04200204,04,20,02,04,3325,1461,2286,1864,422,1039,100.0,43.93984962406015,68.75187969924812,56.060150375939855,12.691729323308271,31.24812030075188
04200205,04,20,02,05,2522,865,2004,1657,347,518,100.0,34.29817605075337,79.46074544012689,65.70182394924663,13.758921490880255,20.539254559873115
04200206,04,20,02,06,2848,893,2396,1955,441,452,100.0,31.355337078651687,84.12921348314607,68.64466292134831,15.484550561797752,15.870786516853933
04200207,04,20,02,07,2996,1134,2189,1862,327,807,100.0,37.850467289719624,73.06408544726301,62.149532710280376,10.914552736982644,26.935914552736982
04200308,04,20,03,08,6113,2320,4684,3793,891,1429,100.0,37.95190577457876,76.62358907246852,62.04809422542124,14.575494847047278,23.37641092753149
04200309,04,20,03,09,6895,2210,5746,4685,1061,1149,100.0,32.05221174764322,83.33575054387236,67.94778825235677,15.387962291515592,16.664249456127628
04200310,04,20,03,10,7533,2922,5951,4611,1340,1582,100.0,38.78932696136997,78.99907075534315,61.21067303863003,17.788397716713128,21.000929244656845
04200311,04,20,03,11,7424,3242,5496,4182,1314,1928,100.0,43.669181034482754,74.03017241379311,56.33081896551724,17.69935344827586,25.969827586206897
04300412,04,30,04,12,4539,2753,2522,1786,736,2017,100.0,60.65212601894691,55.56289931703018,39.34787398105309,16.21502533597709,44.43710068296981
04300413,04,30,04,13,9973,4932,7463,5041,2422,2510,100.0,49.453524516193724,74.83204652561916,50.546475483806276,24.285571041812894,25.167953474380827
04300414,04,30,04,14,10581,4380,8075,6201,1874,2506,100.0,41.39495321803232,76.31603818164635,58.60504678196767,17.71099139967867,23.68396181835365
04300415,04,30,04,15,6258,2581,4774,3677,1097,1484,100.0,41.243208692873125,76.28635346756153,58.756791307126875,17.529562160434644,23.713646532438478
04300416,04,30,04,16,11646,5032,8716,6614,2102,2930,100.0,43.20796840116778,74.8411471749957,56.79203159883222,18.04911557616349,25.158852825004292
04300517,04,30,05,17,9468,4788,6534,4680,1854,2934,100.0,50.57034220532319,69.01140684410646,49.42965779467681,19.581749049429657,30.988593155893536
04300518,04,30,05,18,6682,3766,4182,2916,1266,2500,100.0,56.36037114636336,62.5860520802155,43.63962885363664,18.94642322657887,37.4139479197845
04300619,04,30,06,19,9007,4428,6431,4579,1852,2576,100.0,49.16176307316532,71.40002220495171,50.83823692683468,20.56178527811702,28.599977795048297
04300620,04,30,06,20,4118,2680,2456,1438,1018,1662,100.0,65.08013598834386,59.64060223409422,34.919864011656145,24.720738222438076,40.35939776590578
04300621,04,30,06,21,10941,5644,7664,5297,2367,3277,100.0,51.58577826524083,70.04844164153185,48.41422173475916,21.63421990677269,29.95155835846815
04300622,04,30,06,22,5269,3209,3482,2060,1422,1787,100.0,60.90339722907573,66.08464604289239,39.09660277092427,26.988043271968117,33.915353957107605
04300623,04,30,06,23,12187,7080,7657,5107,2550,4530,100.0,58.09469106424879,62.82924427668828,41.905308935751215,20.923935340937064,37.17075572331173
04300624,04,30,06,24,9314,4390,6608,4924,1684,2706,100.0,47.13334764870088,70.94696156323813,52.866652351299116,18.080309211939017,29.053038436761863
04400725,04,40,07,25,61,35,33,26,7,28,100.0,57.377049180327866,54.09836065573771,42.62295081967213,11.475409836065573,45.90163934426229
04400726,04,40,07,26,5417,2511,4072,2906,1166,1345,100.0,46.35407051873731,75.17075872254016,53.64592948126269,21.52482924127746,24.82924127745985
04400727,04,40,07,27,8322,3700,6271,4622,1649,2051,100.0,44.460466234078346,75.35448209565008,55.539533765921654,19.81494832972843,24.645517904349916
04400728,04,40,07,28,3189,1368,2469,1821,648,720,100.0,42.89746001881468,77.42238946378176,57.10253998118533,20.319849482596425,22.577610536218252
04400729,04,40,07,29,2840,1186,2244,1654,590,596,100.0,41.76056338028169,79.01408450704224,58.23943661971831,20.774647887323944,20.985915492957748
04400830,04,40,08,30,8457,4179,5993,4278,1715,2464,100.0,49.41468605888613,70.86437270899846,50.585313941113874,20.279058767884592,29.135627291001537
04400831,04,40,08,31,1543,516,1295,1027,268,248,100.0,33.44134802333117,83.92741412832146,66.55865197666883,17.368762151652625,16.072585871678548
04400832,04,40,08,32,6998,2047,5884,4951,933,1114,100.0,29.251214632752216,84.08116604744212,70.74878536724778,13.332380680194342,15.918833952557874
04400833,04,40,08,33,3901,1550,3134,2351,783,767,100.0,39.73340169187388,80.33837477569854,60.26659830812612,20.071776467572416,19.66162522430146
04400834,04,40,08,34,3384,1184,2769,2200,569,615,100.0,34.988179669030735,81.82624113475178,65.01182033096927,16.814420803782507,18.173758865248228
04400835,04,40,08,35,10164,3000,8564,7164,1400,1600,100.0,29.515938606847698,84.25816607634789,70.4840613931523,13.774104683195592,15.741833923652104
04500936,04,50,09,36,5621,2701,4012,2920,1092,1609,100.0,48.05194805194805,71.37520014232342,51.94805194805194,19.42714819427148,28.62479985767657
04500937,04,50,09,37,7653,3500,5576,4153,1423,2077,100.0,45.73369920292696,72.86031621586307,54.26630079707304,18.594015418790015,27.139683784136942
04500938,04,50,09,38,8281,4113,5898,4168,1730,2383,100.0,49.66791450307934,71.2232822122932,50.33208549692066,20.89119671537254,28.7767177877068
04500939,04,50,09,39,6761,3554,4772,3207,1565,1989,100.0,52.56618843366366,70.58127495932554,47.433811566336345,23.147463392989202,29.418725040674452
04501040,04,50,10,40,5895,2770,4376,3125,1251,1519,100.0,46.988973706530956,74.23240033927057,53.011026293469044,21.22137404580153,25.767599660729434
04501041,04,50,10,41,5420,2608,3884,2812,1072,1536,100.0,48.11808118081181,71.66051660516605,51.881918819188186,19.778597785977862,28.339483394833948
04501042,04,50,10,42,3664,2192,2299,1472,827,1365,100.0,59.82532751091703,62.74563318777293,40.174672489082965,22.57096069868996,37.254366812227076
04501043,04,50,10,43,10999,5323,7903,5676,2227,3096,100.0,48.395308664424036,71.8519865442313,51.60469133557596,20.247295208655334,28.148013455768705
04501044,04,50,10,44,5328,2421,3890,2907,983,1438,100.0,45.439189189189186,73.0105105105105,54.560810810810814,18.4496996996997,26.989489489489486
04501045,04,50,10,45,9363,4897,6294,4466,1828,3069,100.0,52.3016127309623,67.22204421659724,47.6983872690377,19.52365694755954,32.77795578340276
04501146,04,50,11,46,4744,2317,3328,2427,901,1416,100.0,48.84064080944351,70.15177065767286,51.1593591905565,18.99241146711636,29.848229342327148
04501147,04,50,11,47,5452,2420,4135,3032,1103,1317,100.0,44.38738077769626,75.8437270726339,55.612619222303735,20.231107850330154,24.156272927366103
04501148,04,50,11,48,4564,2267,3218,2297,921,1346,100.0,49.67134092900964,70.50832602979841,50.328659070990355,20.179666958808063,29.491673970201575
04501149,04,50,11,49,9878,4310,7369,5568,1801,2509,100.0,43.63231423365054,74.60012148208139,56.36768576634946,18.232435715731928,25.399878517918605
04501150,04,50,11,50,3016,1252,2261,1764,497,755,100.0,41.51193633952255,74.96684350132627,58.48806366047745,16.478779840848805,25.03315649867374
04501151,04,50,11,51,7420,2687,5944,4733,1211,1476,100.0,36.21293800539084,80.1078167115903,63.78706199460916,16.32075471698113,19.892183288409704
04501152,04,50,11,52,6861,3185,4998,3676,1322,1863,100.0,46.421804401690714,72.84652383034543,53.578195598309286,19.268328232036147,27.153476169654567
04501153,04,50,11,53,7563,3718,5407,3845,1562,2156,100.0,49.160386090175855,71.49279386486845,50.839613909824145,20.653179955044294,28.507206135131565
05100101,05,10,01,01,4504,1254,3929,3250,679,575,100.0,27.841918294849023,87.2335701598579,72.15808170515098,15.075488454706928,12.766429840142097
05100102,05,10,01,02,4377,1338,3581,3039,542,796,100.0,30.568882796435915,81.81402787297235,69.43111720356409,12.38291066940827,18.185972127027643
05100103,05,10,01,03,6107,3289,4115,2818,1297,1992,100.0,53.8562305551007,67.3816931390208,46.1437694448993,21.2379236941215,32.6183068609792
05100104,05,10,01,04,6960,3759,4594,3201,1393,2366,100.0,54.008620689655174,66.00574712643679,45.991379310344826,20.014367816091955,33.99425287356322
05100105,05,10,01,05,7689,1883,6777,5806,971,912,100.0,24.48953049811419,88.13889972688256,75.51046950188581,12.628430224996748,11.86110027311744
05100206,05,10,02,06,3623,1723,2608,1900,708,1015,100.0,47.55727297819487,71.98454319624621,52.44272702180513,19.54181617444107,28.015456803753796
05100207,05,10,02,07,2331,724,2057,1607,450,274,100.0,31.05963105963106,88.24538824538824,68.94036894036894,19.305019305019304,11.754611754611755
05100208,05,10,02,08,11137,5891,7690,5246,2444,3447,100.0,52.8957528957529,69.04911556074347,47.10424710424711,21.944868456496362,30.950884439256534
05100209,05,10,02,09,11935,6953,8329,4982,3347,3606,100.0,58.257226644323424,69.7863426895685,41.74277335567658,28.043569333891917,30.2136573104315
05100210,05,10,02,10,7911,3614,5493,4297,1196,2418,100.0,45.683225888004046,69.43496397421313,54.316774111995954,15.118189862217166,30.565036025786878
05100211,05,10,02,11,6210,2523,4899,3687,1212,1311,100.0,40.6280193236715,78.88888888888889,59.371980676328505,19.516908212560384,21.11111111111111
05100312,05,10,03,12,4007,1880,2759,2127,632,1248,100.0,46.91789368604941,68.85450461692038,53.08210631395058,15.772398302969803,31.145495383079613
05100313,05,10,03,13,7231,4361,4561,2870,1691,2670,100.0,60.30977734753146,63.075646521919516,39.690222652468535,23.385423869450975,36.924353478080484
05100314,05,10,03,14,7493,4879,3934,2614,1320,3559,100.0,65.11410649939944,52.5023355131456,34.88589350060056,17.616442012545043,47.4976644868544
05100315,05,10,03,15,7334,3867,4688,3467,1221,2646,100.0,52.72702481592583,63.92146168530134,47.27297518407417,16.64848650122716,36.07853831469867
05100316,05,10,03,16,10505,5031,7489,5474,2015,3016,100.0,47.89148024750119,71.28986197049024,52.10851975249881,19.181342217991432,28.710138029509757
05100317,05,10,03,17,4458,2779,2141,1679,462,2317,100.0,62.337371018393895,48.02602063705697,37.6626289816061,10.363391655450876,51.97397936294303
05200418,05,20,04,18,3847,979,3533,2868,665,314,100.0,25.448401351702625,91.83779568494931,74.55159864829739,17.286197036651938,8.162204315050689
05200419,05,20,04,19,1632,97,1601,1535,66,31,100.0,5.943627450980392,98.10049019607843,94.05637254901961,4.044117647058823,1.8995098039215685
05200420,05,20,04,20,5910,2193,4828,3717,1111,1082,100.0,37.10659898477157,81.69204737732656,62.89340101522842,18.79864636209814,18.307952622673433
05200421,05,20,04,21,4360,1536,3379,2824,555,981,100.0,35.22935779816514,77.5,64.77064220183486,12.729357798165136,22.5
05200422,05,20,04,22,1201,370,992,831,161,209,100.0,30.80766028309742,82.59783513738552,69.19233971690258,13.40549542048293,17.402164862614487
05200423,05,20,04,23,6809,2798,5124,4011,1113,1685,100.0,41.09267146423851,75.25334116610368,58.90732853576149,16.346012630342194,24.746658833896316
05200524,05,20,05,24,3380,1073,2919,2307,612,461,100.0,31.74556213017751,86.36094674556213,68.25443786982248,18.106508875739642,13.639053254437869
05200525,05,20,05,25,2464,787,2153,1677,476,311,100.0,31.939935064935064,87.37824675324676,68.06006493506493,19.318181818181817,12.621753246753247
05200526,05,20,05,26,5806,3679,3290,2127,1163,2516,100.0,63.3654839820875,56.66551842921116,36.6345160179125,20.031002411298658,43.33448157078884
05200527,05,20,05,27,12030,8153,7165,3877,3288,4865,100.0,67.77223607647548,59.55943474646717,32.22776392352452,27.331670822942645,40.44056525353283
05200528,05,20,05,28,7291,2496,5936,4795,1141,1355,100.0,34.23398710739268,81.4154436977095,65.76601289260734,15.64943080510218,18.584556302290494
05200629,05,20,06,29,8357,3934,5832,4423,1409,2525,100.0,47.07430896254637,69.78580830441547,52.92569103745364,16.860117266961826,30.214191695584542
05200630,05,20,06,30,10042,4391,7193,5651,1542,2849,100.0,43.72634933280223,71.62915753833897,56.27365066719777,15.355506871141205,28.370842461661024
05200631,05,20,06,31,8679,4007,6056,4672,1384,2623,100.0,46.1689134692937,69.77762415024772,53.83108653070631,15.94653761954142,30.222375849752275
05200632,05,20,06,32,3655,1896,2459,1759,700,1196,100.0,51.874145006839946,67.27770177838576,48.125854993160054,19.151846785225718,32.722298221614224
05200633,05,20,06,33,2159,765,1759,1394,365,400,100.0,35.43307086614173,81.47290412227883,64.56692913385827,16.905974988420567,18.527095877721166
05200634,05,20,06,34,4319,886,3854,3433,421,465,100.0,20.51400787219264,89.23361889326233,79.48599212780736,9.747626765454967,10.766381106737672
05300735,05,30,07,35,4520,2978,3155,1542,1613,1365,100.0,65.88495575221239,69.80088495575221,34.115044247787615,35.6858407079646,30.199115044247787
05300736,05,30,07,36,3575,2031,2720,1544,1176,855,100.0,56.811188811188806,76.08391608391608,43.18881118881119,32.89510489510489,23.916083916083917
05300737,05,30,07,37,11913,6088,8668,5825,2843,3245,100.0,51.10383614538739,72.76084949215144,48.89616385461261,23.864685637538823,27.23915050784857
05300838,05,30,08,38,16,3,13,13,0,3,100.0,18.75,81.25,81.25,0.0,18.75
05300839,05,30,08,39,8314,4551,5713,3763,1950,2601,100.0,54.73899446716381,68.71541977387538,45.26100553283618,23.454414241039213,31.284580226124607
05300840,05,30,08,40,503,273,337,230,107,166,100.0,54.27435387673957,66.99801192842942,45.72564612326044,21.272365805168985,33.00198807157058
05300841,05,30,08,41,4605,2380,3198,2225,973,1407,100.0,51.68295331161781,69.44625407166124,48.31704668838219,21.129207383279045,30.55374592833876
05400942,05,40,09,42,3691,852,3316,2839,477,375,100.0,23.083175291248985,89.84015172040097,76.91682470875102,12.92332701164996,10.159848279599025
05400943,05,40,09,43,10533,2363,9673,8170,1503,860,100.0,22.43425424855217,91.83518465774233,77.56574575144784,14.269438906294504,8.164815342257667
05400944,05,40,09,44,2183,436,1992,1747,245,191,100.0,19.972514887769126,91.2505726065048,80.02748511223088,11.223087494273935,8.749427393495191
05400945,05,40,09,45,3671,677,3412,2994,418,259,100.0,18.44184146009262,92.94470171615363,81.55815853990738,11.386543176246255,7.055298283846363
06100101,06,10,01,01,6912,2103,5841,4809,1032,1071,100.0,30.42534722222222,84.50520833333334,69.57465277777779,14.930555555555555,15.494791666666666
06100102,06,10,01,02,9048,3782,6854,5266,1588,2194,100.0,41.799292661361626,75.75154730327144,58.20070733863837,17.55083996463307,24.24845269672856
06100103,06,10,01,03,6186,2163,5147,4023,1124,1039,100.0,34.96605237633366,83.20400905269965,65.03394762366635,18.170061429033304,16.795990947300353
06100204,06,10,02,04,6803,2663,5420,4140,1280,1383,100.0,39.1444950757019,79.6707334999265,60.855504924298096,18.8152285756284,20.329266500073498
06100205,06,10,02,05,9988,3815,7962,6173,1789,2026,100.0,38.195835002002404,79.71565879054866,61.8041649979976,17.911493792551063,20.28434120945134
06100206,06,10,02,06,7751,2761,6232,4990,1242,1519,100.0,35.62121016643014,80.40252870597342,64.37878983356985,16.023738872403563,19.597471294026576
06100207,06,10,02,07,8168,3201,6385,4967,1418,1783,100.0,39.189520078354555,78.17091087169442,60.810479921645445,17.360430950048972,21.829089128305583
06100208,06,10,02,08,7065,2468,5775,4597,1178,1290,100.0,34.932767162066526,81.74097664543525,65.06723283793347,16.67374380750177,18.259023354564754
06100209,06,10,02,09,9322,3798,7255,5524,1731,2067,100.0,40.74232997210899,77.82664664235142,59.25767002789101,18.568976614460418,22.173353357648573
06100210,06,10,02,10,5004,1709,4072,3295,777,932,100.0,34.15267785771383,81.37490007993605,65.84732214228617,15.52757793764988,18.62509992006395
06200311,06,20,03,11,4873,1386,4194,3487,707,679,100.0,28.442437923250562,86.06607839113482,71.55756207674943,14.508516314385389,13.933921608865177
06200312,06,20,03,12,6285,2270,4923,4015,908,1362,100.0,36.11774065234686,78.32935560859188,63.88225934765315,14.447096260938745,21.670644391408114
06200313,06,20,03,13,7395,2775,5880,4620,1260,1515,100.0,37.52535496957404,79.5131845841785,62.47464503042597,17.038539553752535,20.486815415821503
06200314,06,20,03,14,7210,2567,5818,4643,1175,1392,100.0,35.60332871012483,80.69348127600556,64.39667128987517,16.296809986130377,19.30651872399445
06200315,06,20,03,15,6890,2613,5553,4277,1276,1337,100.0,37.924528301886795,80.59506531204644,62.075471698113205,18.519593613933235,19.404934687953556
06200316,06,20,03,16,5788,2707,4219,3081,1138,1569,100.0,46.76917760884589,72.89219073946094,53.230822391154106,19.661368348306844,27.107809260539046
06200317,06,20,03,17,6257,1486,5580,4771,809,677,100.0,23.749400671248203,89.18011826754035,76.2505993287518,12.929518938788556,10.819881732459645
06200418,06,20,04,18,0,0,0,0,0,0,0.0,0.0,0.0,0.0,0.0,0.0
06200419,06,20,04,19,4539,2553,3170,1986,1184,1369,100.0,56.245869134170526,69.83917162370567,43.754130865829474,26.085040757876182,30.160828376294337
06200420,06,20,04,20,7403,2533,5933,4870,1063,1470,100.0,34.21585843576928,80.14318519519114,65.78414156423071,14.359043630960421,19.856814804808863
06200421,06,20,04,21,8417,2683,6861,5734,1127,1556,100.0,31.87596530830462,81.51360342164666,68.12403469169539,13.38956872995129,18.486396578353332
06200422,06,20,04,22,7009,1777,5982,5232,750,1027,100.0,25.35311742045941,85.34741047224996,74.64688257954059,10.700527892709372,14.652589527750035
06200423,06,20,04,23,8606,2751,7289,5855,1434,1317,100.0,31.966070183592844,84.69672321636068,68.03392981640715,16.66279339995352,15.303276783639323
06300524,06,30,05,24,5624,1573,4753,4051,702,871,100.0,27.969416785206256,84.51280227596017,72.03058321479374,12.48221906116643,15.48719772403983
06300525,06,30,05,25,5820,1790,4776,4030,746,1044,100.0,30.756013745704468,82.06185567010309,69.24398625429554,12.817869415807559,17.938144329896907
06300526,06,30,05,26,3350,1151,2717,2199,518,633,100.0,34.35820895522388,81.1044776119403,65.64179104477613,15.46268656716418,18.895522388059703
06300527,06,30,05,27,8541,2754,7171,5787,1384,1370,100.0,32.24446786090622,83.95972368575109,67.75553213909379,16.204191546657302,16.040276314248917
06300528,06,30,05,28,10947,3007,9446,7940,1506,1501,100.0,27.468712889376086,86.28848086233671,72.53128711062391,13.757193751712798,13.711519137663286
06300629,06,30,06,29,6988,2158,5843,4830,1013,1145,100.0,30.881511161991988,83.61476817401258,69.11848883800802,14.49627933600458,16.385231825987407
06300630,06,30,06,30,5667,2493,4039,3174,865,1628,100.0,43.9915299100053,71.27227810128815,56.00847008999471,15.263808011293452,28.727721898711838
06300631,06,30,06,31,2881,1089,2188,1792,396,693,100.0,37.799375216938564,75.94585213467546,62.20062478306144,13.745227351614023,24.05414786532454
06300632,06,30,06,32,13695,4393,11632,9302,2330,2063,100.0,32.07740051113545,84.93610806863819,67.92259948886455,17.01350857977364,15.06389193136181
06300633,06,30,06,33,11955,3526,10035,8429,1606,1920,100.0,29.493935591802593,83.93977415307403,70.50606440819742,13.433709744876621,16.06022584692597
06300634,06,30,06,34,8285,2195,7117,6090,1027,1168,100.0,26.493663246831623,85.90223295111647,73.50633675316838,12.3958961979481,14.097767048883526
06400735,06,40,07,35,10188,2635,8716,7553,1163,1472,100.0,25.863761287789554,85.55162936788379,74.13623871221044,11.415390655673342,14.448370632116214
06400736,06,40,07,36,5139,1225,4628,3914,714,511,100.0,23.83732243627165,90.05643121229812,76.16267756372835,13.89375364856976,9.943568787701887
06400737,06,40,07,37,11337,3975,8622,7362,1260,2715,100.0,35.062185763429476,76.05186557290288,64.93781423657052,11.114051336332363,23.948134427097116
06400838,06,40,08,38,7341,1521,6630,5820,810,711,100.0,20.71924805884757,90.31467102574581,79.28075194115243,11.03391908459338,9.685328974254189
06400839,06,40,08,39,5370,1354,4700,4016,684,670,100.0,25.214152700186222,87.52327746741155,74.78584729981378,12.737430167597767,12.476722532588454
06400840,06,40,08,40,7080,1394,6408,5686,722,672,100.0,19.689265536723163,90.5084745762712,80.31073446327683,10.197740112994351,9.491525423728813
06400841,06,40,08,41,6191,1930,5120,4261,859,1071,100.0,31.174285252786305,82.70069455661444,68.8257147472137,13.874979809400742,17.29930544338556
06400842,06,40,08,42,4773,1889,4017,2884,1133,756,100.0,39.576786088413996,84.16090509113765,60.423213911586004,23.737691179551646,15.83909490886235
06400843,06,40,08,43,4690,1479,3900,3211,689,790,100.0,31.535181236673775,83.15565031982942,68.46481876332624,14.690831556503198,16.844349680170577
06400844,06,40,08,44,7263,2623,5903,4640,1263,1360,100.0,36.11455321492496,81.27495525265041,63.88544678507504,17.389508467575382,18.725044747349582
07100101,07,10,01,01,9794,5026,6904,4768,2136,2890,100.0,51.317132938533796,70.49213804370022,48.682867061466204,21.809270982234022,29.507861956299774
07100102,07,10,01,02,8696,4746,5603,3950,1653,3093,100.0,54.5768169273229,64.43192272309108,45.42318307267709,19.008739650413983,35.56807727690892
07100103,07,10,01,03,7897,5223,4895,2674,2221,3002,100.0,66.13904014182602,61.98556413828036,33.86095985817399,28.124604280106368,38.01443586171964
07100204,07,10,02,04,10425,4436,7721,5989,1732,2704,100.0,42.5515587529976,74.06235011990407,57.4484412470024,16.61390887290168,25.937649880095925
07100205,07,10,02,05,5177,3498,3180,1679,1501,1997,100.0,67.56808962719721,61.42553602472475,32.43191037280278,28.99362565192196,38.57446397527526
07100206,07,10,02,06,8355,4330,5842,4025,1817,2513,100.0,51.825254338719326,69.92220227408737,48.174745661280674,21.747456612806705,30.077797725912625
07200307,07,20,03,07,10549,4195,8298,6354,1944,2251,100.0,39.76680254052517,78.66148450090056,60.23319745947483,18.42828704142573,21.338515499099444
07200308,07,20,03,08,10698,5246,7518,5452,2066,3180,100.0,49.03720321555431,70.27481772293886,50.962796784445686,19.312020938493177,29.725182277061137
07200409,07,20,04,09,9300,3618,7286,5682,1604,2014,100.0,38.903225806451616,78.34408602150538,61.096774193548384,17.24731182795699,21.655913978494624
07200410,07,20,04,10,5538,3074,3855,2464,1391,1683,100.0,55.50740339472734,69.60996749729144,44.49259660527266,25.11737089201878,30.390032502708557
07200411,07,20,04,11,2741,1269,2014,1472,542,727,100.0,46.29697190806275,73.47683327252827,53.70302809193724,19.773805180591026,26.523166727471725
07200412,07,20,04,12,2611,1609,1644,1002,642,967,100.0,61.62389888931445,62.964381463040986,38.37610111068556,24.58828035235542,37.03561853695902
07200413,07,20,04,13,7708,2897,6032,4811,1221,1676,100.0,37.584327970939285,78.25635703165543,62.41567202906072,15.840685002594707,21.743642968344577
07200414,07,20,04,14,3778,1599,2908,2179,729,870,100.0,42.32398094229751,76.97194282689253,57.67601905770249,19.295923769190047,23.028057173107463
07300515,07,30,05,15,6961,2071,5914,4890,1024,1047,100.0,29.751472489584827,84.95905760666571,70.24852751041517,14.710530096250537,15.040942393334293
07300516,07,30,05,16,8896,2919,7273,5977,1296,1623,100.0,32.8125,81.755845323741,67.1875,14.568345323741008,18.24415467625899
07300517,07,30,05,17,10082,3879,7863,6203,1660,2219,100.0,38.47450902598691,77.99047807974608,61.525490974013096,16.46498710573299,22.00952192025392
07300618,07,30,06,18,9243,3336,7465,5907,1558,1778,100.0,36.09217786432976,80.76382127015039,63.90782213567023,16.855999134480147,19.236178729849616
07300619,07,30,06,19,12219,5835,9140,6384,2756,3079,100.0,47.753498649644,74.80153858744578,52.246501350356,22.555037237089778,25.198461412554217
07400720,07,40,07,20,11668,5181,9149,6487,2662,2519,100.0,44.40349674322934,78.4110387384299,55.59650325677066,22.81453548165924,21.588961261570105
07400721,07,40,07,21,7639,4090,4540,3549,991,3099,100.0,53.54103940306323,59.43186280926823,46.45896059693677,12.972902212331459,40.568137190731775
07400822,07,40,08,22,3291,1369,2436,1922,514,855,100.0,41.59829838954725,74.02005469462169,58.40170161045275,15.618353084168945,25.979945305378305
07400823,07,40,08,23,9690,3869,7714,5821,1893,1976,100.0,39.92776057791538,79.6078431372549,60.07223942208463,19.53560371517028,20.392156862745097
07400824,07,40,08,24,7387,3204,5579,4183,1396,1808,100.0,43.373493975903614,75.52457019087586,56.62650602409639,18.898064166779477,24.475429809124137
07400825,07,40,08,25,7213,3313,5364,3900,1464,1849,100.0,45.93095799251351,74.3657285456814,54.06904200748648,20.296686538194926,25.63427145431859
07400826,07,40,08,26,5110,1660,4281,3450,831,829,100.0,32.4853228962818,83.77690802348337,67.5146771037182,16.262230919765166,16.223091976516635
07400927,07,40,09,27,11415,5744,8060,5671,2389,3355,100.0,50.3197547087166,70.60884800700832,49.6802452912834,20.928602715724924,29.391151992991677
07400928,07,40,09,28,3965,2449,2388,1516,872,1577,100.0,61.76544766708702,60.22698612862547,38.23455233291299,21.992433795712486,39.77301387137453
07501029,07,50,10,29,8544,4063,6359,4481,1878,2185,100.0,47.55383895131086,74.42649812734082,52.44616104868914,21.980337078651687,25.573501872659175
07501030,07,50,10,30,8753,3988,6651,4765,1886,2102,100.0,45.56152176396664,75.98537644236262,54.43847823603336,21.54689820632926,24.014623557637382
07501031,07,50,10,31,9124,3467,7406,5657,1749,1718,100.0,37.99868478737396,81.17053923717667,62.00131521262604,19.169224024550637,18.82946076282332
07501032,07,50,10,32,6284,2596,5082,3688,1394,1202,100.0,41.31126670910248,80.8720560152769,58.688733290897524,22.183322724379376,19.127943984723107
07501133,07,50,11,33,8254,3788,5997,4466,1531,2257,100.0,45.892900411921495,72.6556820935304,54.10709958807851,18.5485825054519,27.34431790646959
07501134,07,50,11,34,10548,3610,8871,6938,1933,1677,100.0,34.22449753507774,84.10125142207053,65.77550246492227,18.325748957148274,15.898748577929464
07501135,07,50,11,35,2257,688,1925,1569,356,332,100.0,30.482941958351795,85.29020824102791,69.5170580416482,15.773150199379707,14.709791758972088
07601236,07,60,12,36,10335,5017,7482,5318,2164,2853,100.0,48.54378326076439,72.39477503628447,51.45621673923561,20.93855829704886,27.60522496371553
07601237,07,60,12,37,4785,1477,4088,3308,780,697,100.0,30.867293625914314,85.43364681295715,69.13270637408569,16.30094043887147,14.566353187042841
07601238,07,60,12,38,2877,1273,2327,1604,723,550,100.0,44.24748001390337,80.88286409454292,55.75251998609663,25.1303441084463,19.117135905457072
07601339,07,60,13,39,5721,2626,4644,3095,1549,1077,100.0,45.90106624715959,81.1746198217095,54.098933752840416,27.075686068869082,18.82538017829051
07601340,07,60,13,40,6416,2997,5102,3419,1683,1314,100.0,46.711346633416454,79.51995012468828,53.28865336658354,26.23129675810474,20.48004987531172
07601341,07,60,13,41,2225,773,1819,1452,367,406,100.0,34.741573033707866,81.75280898876404,65.25842696629213,16.49438202247191,18.247191011235955
07601442,07,60,14,42,10408,2843,9067,7565,1502,1341,100.0,27.315526518063027,87.11568024596464,72.68447348193698,14.43120676402767,12.884319754035358
07601443,07,60,14,43,10849,2967,9529,7882,1647,1320,100.0,27.34814268596184,87.83297999815652,72.65185731403815,15.181122684118353,12.167020001843488
07601544,07,60,15,44,9262,3511,7540,5751,1789,1722,100.0,37.907579356510475,81.40790326063485,62.09242064348953,19.315482617145324,18.59209673936515
07601545,07,60,15,45,8570,3727,6578,4843,1735,1992,100.0,43.48891481913652,76.7561260210035,56.511085180863475,20.245040840140025,23.243873978996497
07601546,07,60,15,46,6977,1681,6209,5296,913,768,100.0,24.09344990683675,88.99240361186756,75.90655009316325,13.085853518704313,11.007596388132434
07601547,07,60,15,47,3828,1012,3238,2816,422,590,100.0,26.436781609195403,84.58725182863114,73.5632183908046,11.024033437826542,15.412748171368861
07601548,07,60,15,48,2896,642,2597,2254,343,299,100.0,22.168508287292816,89.67541436464089,77.83149171270718,11.8439226519337,10.324585635359115
08100101,08,10,01,01,4626,2685,2836,1941,895,1790,100.0,58.04150453955902,61.30566364029399,41.958495460440986,19.347168179853007,38.694336359706014
08100102,08,10,01,02,8181,4539,5196,3642,1554,2985,100.0,55.48221488815548,63.513017968463515,44.51778511184452,18.995232856618998,36.486982031536485
08100103,08,10,01,03,7205,3724,4838,3481,1357,2367,100.0,51.68632893823734,67.14781401804302,48.31367106176266,18.83414295628036,32.85218598195697
08100104,08,10,01,04,6699,4068,4115,2631,1484,2584,100.0,60.725481415136585,61.42707866845798,39.27451858486341,22.152560083594565,38.57292133154202
08100105,08,10,01,05,6338,4004,3956,2334,1622,2382,100.0,63.1745029977911,62.41716629851688,36.8254970022089,25.591669296307984,37.58283370148312
08100206,08,10,02,06,9350,5570,5751,3780,1971,3599,100.0,59.57219251336898,61.50802139037433,40.42780748663102,21.080213903743317,38.49197860962567
08100207,08,10,02,07,7442,5088,4775,2354,2421,2667,100.0,68.36871808653588,64.16285944638538,31.63128191346412,32.531577532921254,35.837140553614624
08100208,08,10,02,08,11955,6944,7489,5011,2478,4466,100.0,58.0844834797156,62.64324550397323,41.9155165202844,20.727728983688834,37.35675449602677
08100209,08,10,02,09,8834,5407,5199,3427,1772,3635,100.0,61.20670138102785,58.852162100973516,38.79329861897215,20.058863482001357,41.14783789902649
08100310,08,10,03,10,7560,3971,5131,3589,1542,2429,100.0,52.52645502645502,67.87037037037037,47.473544973544975,20.396825396825395,32.12962962962963
08100311,08,10,03,11,7076,3527,4796,3549,1247,2280,100.0,49.84454494064443,67.7784058790277,50.15545505935557,17.62295081967213,32.221594120972306
08100312,08,10,03,12,11499,6162,7583,5337,2246,3916,100.0,53.58726845812679,65.94486477084965,46.41273154187321,19.532133228976434,34.055135229150366
08100313,08,10,03,13,3740,1480,2932,2260,672,808,100.0,39.57219251336899,78.39572192513369,60.42780748663101,17.967914438502675,21.604278074866308
08100314,08,10,03,14,7930,4893,4736,3037,1699,3194,100.0,61.70239596469105,59.72257250945776,38.29760403530895,21.424968474148802,40.277427490542244
08100415,08,10,04,15,6388,3535,4123,2853,1270,2265,100.0,55.33813400125235,64.54289292423294,44.66186599874765,19.881026925485283,35.45710707576706
08100416,08,10,04,16,6577,3647,4249,2930,1319,2328,100.0,55.45081344077847,64.6039227611373,44.54918655922153,20.05473620191577,35.3960772388627
08100417,08,10,04,17,9569,5416,6063,4153,1910,3506,100.0,56.599435677709266,63.36085275368377,43.40056432229073,19.96028843139304,36.63914724631623
08100418,08,10,04,18,9193,4525,6344,4668,1676,2849,100.0,49.222234308713155,69.00902860872404,50.777765691286845,18.23126291743718,30.990971391275973
08100419,08,10,04,19,7192,4651,4110,2541,1569,3082,100.0,64.6690767519466,57.146829810901004,35.330923248053395,21.81590656284761,42.853170189098996
08100520,08,10,05,20,5737,4418,3420,1319,2101,2317,100.0,77.00888966358724,59.61303817326129,22.99111033641276,36.62192783684853,40.38696182673871
08100521,08,10,05,21,9457,6551,6371,2906,3465,3086,100.0,69.27143914560642,67.36808713122555,30.72856085439357,36.63952627683197,32.63191286877446
08200622,08,20,06,22,5860,4214,3059,1646,1413,2801,100.0,71.91126279863481,52.201365187713314,28.088737201365188,24.112627986348123,47.798634812286686
08200623,08,20,06,23,6692,3660,4368,3032,1336,2324,100.0,54.692169754931264,65.27196652719665,45.307830245068736,19.964136282127914,34.72803347280335
08200624,08,20,06,24,8988,4781,6394,4207,2187,2594,100.0,53.19314641744548,71.13929684023142,46.80685358255452,24.332443257676903,28.86070315976858
08200725,08,20,07,25,2524,921,2147,1603,544,377,100.0,36.48969889064976,85.06339144215531,63.510301109350245,21.553090332805073,14.936608557844691
08200726,08,20,07,26,6109,2033,5146,4076,1070,963,100.0,33.27876902930103,84.23637256506792,66.72123097069897,17.515141594368963,15.763627434932067
08200727,08,20,07,27,8115,2991,6630,5124,1506,1485,100.0,36.85767097966728,81.70055452865064,63.142329020332724,18.55822550831793,18.299445471349355
08200728,08,20,07,28,1206,424,1014,782,232,192,100.0,35.1575456053068,84.07960199004975,64.8424543946932,19.237147595356554,15.92039800995025
08200729,08,20,07,29,1869,737,1563,1132,431,306,100.0,39.43285179240236,83.62760834670947,60.56714820759764,23.060460139111825,16.37239165329053
08200730,08,20,07,30,3373,1276,2680,2097,583,693,100.0,37.8298250815298,79.45449155054848,62.1701749184702,17.28431663207827,20.54550844945153
08200831,08,20,08,31,8275,2739,7020,5536,1484,1255,100.0,33.09969788519637,84.83383685800604,66.90030211480362,17.93353474320242,15.166163141993957
08200832,08,20,08,32,12116,4738,9955,7378,2577,2161,100.0,39.10531528557279,82.1640805546385,60.89468471442721,21.269395840211292,17.835919445361505
08200833,08,20,08,33,9255,5007,6561,4248,2313,2694,100.0,54.100486223662884,70.89141004862236,45.899513776337116,24.991896272285253,29.108589951377635
08300934,08,30,09,34,12623,7220,9673,5403,4270,2950,100.0,57.19717975124772,76.62996118196942,42.802820248752276,33.827140933217144,23.37003881803058
08300935,08,30,09,35,7611,3935,5823,3676,2147,1788,100.0,51.7014846932072,76.50768624359479,48.2985153067928,28.209170936801996,23.492313756405203
08301036,08,30,10,36,7448,3954,5813,3494,2319,1635,100.0,53.088077336197635,78.04779806659506,46.911922663802365,31.135875402792696,21.95220193340494
08301037,08,30,10,37,11049,6805,8279,4244,4035,2770,100.0,61.58928409810842,74.92985790569281,38.41071590189157,36.51914200380125,25.07014209430718
08401138,08,40,11,38,2900,1131,2406,1769,637,494,100.0,39.0,82.9655172413793,61.0,21.96551724137931,17.03448275862069
08401139,08,40,11,39,4092,1637,3321,2455,866,771,100.0,40.00488758553274,81.158357771261,59.99511241446726,21.163245356793745,18.841642228739
08401140,08,40,11,40,2670,1078,2182,1592,590,488,100.0,40.37453183520599,81.72284644194757,59.62546816479401,22.09737827715356,18.277153558052433
08401241,08,40,12,41,8319,3559,6731,4760,1971,1588,100.0,42.78158432503907,80.91116720759707,57.21841567496093,23.692751532636134,19.088832792402933
08401242,08,40,12,42,6893,2172,6003,4721,1282,890,100.0,31.510227767300158,87.08835050050776,68.48977223269983,18.598578267807923,12.911649499492238
08401243,08,40,12,43,10078,3620,8351,6458,1893,1727,100.0,35.91982536217503,82.8636634252828,64.08017463782497,18.783488787457827,17.136336574717205
08401244,08,40,12,44,7315,2207,6506,5108,1398,809,100.0,30.17088174982912,88.94053315105947,69.82911825017088,19.111414900888583,11.059466848940533
08401245,08,40,12,45,3720,1288,3259,2432,827,461,100.0,34.623655913978496,87.60752688172043,65.3763440860215,22.231182795698924,12.39247311827957
08401246,08,40,12,46,7840,2466,6796,5374,1422,1044,100.0,31.454081632653065,86.68367346938776,68.54591836734694,18.137755102040817,13.316326530612244
09100101,09,10,01,01,13453,4924,10508,8529,1979,2945,100.0,36.60150152382368,78.10897197651082,63.398498476176314,14.710473500334498,21.891028023489184
09100202,09,10,02,02,4280,1035,3686,3245,441,594,100.0,24.182242990654206,86.1214953271028,75.8177570093458,10.30373831775701,13.878504672897197
09100203,09,10,02,03,7473,2305,5801,5168,633,1672,100.0,30.844373076408406,77.62612070119096,69.1556269235916,8.470493777599359,22.373879298809047
09100304,09,10,03,04,12007,2931,10191,9076,1115,1816,100.0,24.41076038977263,84.87548929790955,75.58923961022737,9.286249687682185,15.124510702090447
09100305,09,10,03,05,4338,1260,3521,3078,443,817,100.0,29.045643153526974,81.16643614568926,70.95435684647303,10.212079299216228,18.833563854310743
09100306,09,10,03,06,3059,1050,2469,2009,460,590,100.0,34.32494279176201,80.71265119320039,65.67505720823799,15.037593984962406,19.28734880679961
09100407,09,10,04,07,8670,1772,7557,6898,659,1113,100.0,20.43829296424452,87.16262975778547,79.56170703575548,7.600922722029988,12.837370242214533
09100408,09,10,04,08,8870,2312,7405,6558,847,1465,100.0,26.065388951521985,83.4836527621195,73.93461104847802,9.549041713641488,16.516347237880495
09100409,09,10,04,09,4096,1226,3519,2870,649,577,100.0,29.931640625,85.9130859375,70.068359375,15.8447265625,14.0869140625
09200510,09,20,05,10,8024,3438,5332,4586,746,2692,100.0,42.846460618145564,66.4506480558325,57.153539381854436,9.297108673978066,33.5493519441675
09200511,09,20,05,11,13207,4259,10203,8948,1255,3004,100.0,32.248050276368595,77.25448625728781,67.75194972363141,9.502536533656395,22.7455137427122
09200512,09,20,05,12,4433,1797,3019,2636,383,1414,100.0,40.536882472366344,68.10286487705842,59.463117527633656,8.639747349424768,31.897135122941574
09200613,09,20,06,13,10704,4498,7256,6206,1050,3448,100.0,42.02167414050822,67.78774289985053,57.978325859491775,9.809417040358746,32.21225710014948
09200614,09,20,06,14,3804,707,3291,3097,194,513,100.0,18.585699263932703,86.5141955835962,81.4143007360673,5.099894847528917,13.485804416403784
09200715,09,20,07,15,4259,2183,2701,2076,625,1558,100.0,51.25616341864288,63.41864287391407,48.74383658135712,14.674806292556939,36.58135712608593
09200716,09,20,07,16,8373,2807,6182,5566,616,2191,100.0,33.5244237429834,73.83255702854413,66.4755762570166,7.356980771527528,26.167442971455866
09200717,09,20,07,17,9785,2734,7771,7051,720,2014,100.0,27.94072560040879,79.41747572815534,72.05927439959122,7.358201328564129,20.58252427184466
09200818,09,20,08,18,4330,1271,3353,3059,294,977,100.0,29.35334872979215,77.4364896073903,70.64665127020785,6.789838337182448,22.5635103926097
09200819,09,20,08,19,8588,2643,6711,5945,766,1877,100.0,30.775500698649278,78.14392175128086,69.22449930135072,8.919422449930135,21.856078248719143
09300920,09,30,09,20,13253,3322,11542,9931,1611,1711,100.0,25.06602278729344,87.08971553610503,74.93397721270657,12.155738323398475,12.910284463894966
09300921,09,30,09,21,2878,587,2534,2291,243,344,100.0,20.396108408617096,88.04725503822098,79.6038915913829,8.443363446838081,11.952744961779013
09300922,09,30,09,22,6013,1665,4922,4348,574,1091,100.0,27.690004989190086,81.85597871278895,72.30999501080991,9.545983701979045,18.144021287211043
09300923,09,30,09,23,9100,3071,7223,6029,1194,1877,100.0,33.74725274725275,79.37362637362637,66.25274725274726,13.12087912087912,20.626373626373624
09301024,09,30,10,24,3776,1119,3112,2657,455,664,100.0,29.634533898305083,82.41525423728814,70.36546610169492,12.04978813559322,17.584745762711865
09301025,09,30,10,25,11919,2869,10007,9050,957,1912,100.0,24.07081130967363,83.95838577061834,75.92918869032637,8.02919708029197,16.041614229381658
09301126,09,30,11,26,8376,1836,7227,6540,687,1149,100.0,21.91977077363897,86.28223495702005,78.08022922636103,8.202005730659026,13.717765042979943
09301227,09,30,12,27,1852,218,1768,1634,134,84,100.0,11.771058315334773,95.46436285097192,88.22894168466523,7.235421166306695,4.535637149028078
09301228,09,30,12,28,2635,383,2439,2252,187,196,100.0,14.535104364326376,92.56166982922201,85.46489563567363,7.096774193548387,7.438330170777989
09401329,09,40,13,29,11009,1539,10037,9470,567,972,100.0,13.979471341629576,91.17086020528659,86.02052865837042,5.150331546916159,8.829139794713416
09401330,09,40,13,30,1916,251,1797,1665,132,119,100.0,13.100208768267224,93.78914405010438,86.89979123173278,6.8893528183716075,6.210855949895616
09401431,09,40,14,31,5992,1181,5146,4811,335,846,100.0,19.709612817089454,85.88117489986648,80.29038718291055,5.590787716955941,14.118825100133511
09401432,09,40,14,32,1572,343,1375,1229,146,197,100.0,21.81933842239186,87.46819338422391,78.18066157760815,9.287531806615776,12.53180661577608
09401433,09,40,14,33,4478,954,3791,3524,267,687,100.0,21.304153640017866,84.65832961143369,78.69584635998214,5.962483251451541,15.341670388566325
09401534,09,40,15,34,7494,2094,6038,5400,638,1456,100.0,27.942353883106485,80.57112356551909,72.05764611689351,8.513477448625567,19.42887643448092
09401635,09,40,16,35,7059,782,6679,6277,402,380,100.0,11.078056381923785,94.61680124663549,88.92194361807621,5.694857628559286,5.3831987533645
09501736,09,50,17,36,4677,672,4233,4005,228,444,100.0,14.368184733803721,90.50673508659398,85.63181526619627,4.8749198203976905,9.49326491340603
09501737,09,50,17,37,14359,1635,13446,12724,722,913,100.0,11.386586809666412,93.64161849710982,88.61341319033359,5.028205306776238,6.358381502890173
09501838,09,50,18,38,11138,1872,10008,9266,742,1130,100.0,16.80732627042557,89.85455198419824,83.19267372957442,6.66187825462381,10.14544801580176
09501939,09,50,19,39,6829,1780,5582,5049,533,1247,100.0,26.065309708595695,81.73963977156245,73.93469029140431,7.804949480158149,18.26036022843755
09501940,09,50,19,40,2759,674,2273,2085,188,486,100.0,24.429140993113446,82.38492207321492,75.57085900688655,6.81406306632838,17.615077926785066
09501941,09,50,19,41,2937,645,2511,2292,219,426,100.0,21.961184882533196,85.49540347293157,78.0388151174668,7.456588355464761,14.504596527068436
09502042,09,50,20,42,4315,792,3777,3523,254,538,100.0,18.35457705677868,87.53186558516802,81.64542294322132,5.886442641946697,12.468134414831981
09502043,09,50,20,43,9147,1138,8457,8009,448,690,100.0,12.44123756422871,92.45654312889472,87.55876243577129,4.897780693123428,7.543456871105281
10100101,10,10,01,01,5837,2049,4515,3788,727,1322,100.0,35.10364913482953,77.35137913311632,64.89635086517046,12.455028267945863,22.64862086688367
10100102,10,10,01,02,3680,1430,2649,2250,399,1031,100.0,38.858695652173914,71.98369565217392,61.141304347826086,10.842391304347826,28.016304347826086
10100103,10,10,01,03,8110,2592,6488,5518,970,1622,100.0,31.960542540073984,80.0,68.03945745992603,11.960542540073984,20.0
10100104,10,10,01,04,7521,2471,6278,5050,1228,1243,100.0,32.85467358064087,83.47294242786863,67.14532641935914,16.32761600850951,16.527057572131366
10100205,10,10,02,05,1221,884,404,337,67,817,100.0,72.3996723996724,33.08763308763309,27.600327600327603,5.487305487305488,66.91236691236692
10100206,10,10,02,06,11809,3958,9343,7851,1492,2466,100.0,33.51680921331188,79.11762215259547,66.48319078668811,12.634431365907359,20.88237784740452
10100207,10,10,02,07,8320,1878,7083,6442,641,1237,100.0,22.572115384615383,85.13221153846153,77.42788461538461,7.704326923076923,14.867788461538462
10100208,10,10,02,08,10330,3534,8083,6796,1287,2247,100.0,34.21103581800581,78.24782187802516,65.78896418199419,12.458857696030979,21.75217812197483
10100209,10,10,02,09,9642,3637,7123,6005,1118,2519,100.0,37.72038996058909,73.87471478946277,62.27961003941091,11.595104750051856,26.12528521053723
10100210,10,10,02,10,10868,3512,8890,7356,1534,1978,100.0,32.315053367684946,81.79977916820023,67.68494663231506,14.114832535885165,18.20022083179978
10100311,10,10,03,11,2670,1246,1737,1424,313,933,100.0,46.666666666666664,65.0561797752809,53.333333333333336,11.722846441947565,34.943820224719104
10100312,10,10,03,12,16216,5981,12437,10235,2202,3779,100.0,36.88332511100148,76.69585594474593,63.116674888998524,13.57918105574741,23.30414405525407
10100313,10,10,03,13,4981,1906,3678,3075,603,1303,100.0,38.265408552499494,73.84059425818108,61.7345914475005,12.106002810680586,26.159405741818915
10100314,10,10,03,14,6455,1633,5536,4822,714,919,100.0,25.298218435321456,85.76297443841983,74.70178156467856,11.061192873741286,14.237025561580172
10100315,10,10,03,15,8228,2977,6441,5251,1190,1787,100.0,36.18133203694701,78.28147788040836,63.81866796305299,14.46280991735537,21.718522119591636
10100316,10,10,03,16,3696,700,3373,2996,377,323,100.0,18.939393939393938,91.26082251082252,81.06060606060606,10.20021645021645,8.73917748917749
10200417,10,20,04,17,8063,3586,5630,4477,1153,2433,100.0,44.474761255115965,69.82512712389929,55.52523874488404,14.299888379015254,30.174872876100707
10200418,10,20,04,18,7367,2245,5709,5122,587,1658,100.0,30.473734220171032,77.49423103027013,69.52626577982896,7.967965250441157,22.505768969729875
10200419,10,20,04,19,4357,2034,2896,2323,573,1461,100.0,46.683497819600646,66.46775304108331,53.31650218039936,13.151250860683957,33.53224695891669
10200420,10,20,04,20,9010,3877,5868,5133,735,3142,100.0,43.029966703662595,65.1276359600444,56.970033296337405,8.157602663706992,34.872364039955606
10200421,10,20,04,21,1757,875,1222,882,340,535,100.0,49.800796812749006,69.55036994877632,50.199203187250994,19.351166761525327,30.449630051223675
10200422,10,20,04,22,7368,3668,4401,3700,701,2967,100.0,49.7828447339848,59.73127035830619,50.2171552660152,9.514115092290988,40.26872964169381
10200423,10,20,04,23,6138,2600,4223,3538,685,1915,100.0,42.35907461713913,68.80091234929945,57.640925382860864,11.159986966438579,31.19908765070055
10200524,10,20,05,24,11814,3889,8919,7925,994,2895,100.0,32.91857118672761,75.4951752158456,67.0814288132724,8.413746402573217,24.504824784154394
10200525,10,20,05,25,5380,1932,3902,3448,454,1478,100.0,35.910780669144984,72.5278810408922,64.08921933085502,8.438661710037175,27.472118959107807
10200526,10,20,05,26,6241,2649,4237,3592,645,2004,100.0,42.44512097420285,67.88976125620894,57.55487902579715,10.334882230411793,32.11023874379106
10200627,10,20,06,27,3689,1078,2993,2611,382,696,100.0,29.22201138519924,81.13309840065058,70.77798861480076,10.355109785849823,18.86690159934942
10200628,10,20,06,28,6514,2107,4997,4407,590,1517,100.0,32.34571691740866,76.71169788148603,67.65428308259133,9.057414798894689,23.288302118513972
10200629,10,20,06,29,9187,2219,7802,6968,834,1385,100.0,24.153695439207574,84.92434962446936,75.84630456079242,9.078045063676935,15.07565037553064
10200630,10,20,06,30,6627,1334,5814,5293,521,813,100.0,20.129772144258336,87.73200543232231,79.87022785574166,7.861777576580654,12.267994567677682
10300731,10,30,07,31,7926,1844,6744,6082,662,1182,100.0,23.265203128942723,85.08705526116577,76.73479687105727,8.352258390108505,14.912944738834216
10300732,10,30,07,32,7237,2047,5923,5190,733,1314,100.0,28.285201050158904,81.84330523697665,71.7147989498411,10.128506287135554,18.156694763023353
10300733,10,30,07,33,5190,1637,4152,3553,599,1038,100.0,31.54142581888247,80.0,68.45857418111754,11.541425818882466,20.0
10300734,10,30,07,34,10606,1733,9776,8873,903,830,100.0,16.339807656043746,92.17424099566284,83.66019234395625,8.514048651706581,7.8257590043371685
10400835,10,40,08,35,7832,936,7373,6896,477,459,100.0,11.95097037793667,94.1394279877426,88.04902962206333,6.090398365679264,5.860572012257405
10400836,10,40,08,36,3981,592,3611,3389,222,370,100.0,14.87063551871389,90.70585280080383,85.1293644812861,5.5764883195177095,9.294147199196182
10400837,10,40,08,37,7870,826,7524,7044,480,346,100.0,10.495552731893266,95.60355781448538,89.50444726810673,6.099110546378653,4.396442185514612
10400938,10,40,09,38,10234,1200,9650,9034,616,584,100.0,11.72562048075044,94.29353136603478,88.27437951924956,6.019151846785226,5.706468633965215
10400939,10,40,09,39,4529,704,4149,3825,324,380,100.0,15.544270258335175,91.60962684919409,84.45572974166483,7.1538971075292555,8.390373150805917
10400940,10,40,09,40,5847,538,5590,5309,281,257,100.0,9.201299811869335,95.60458354711818,90.79870018813067,4.805883358987515,4.395416452881819
10400941,10,40,09,41,9743,1046,9285,8697,588,458,100.0,10.735912963153032,95.29918916144925,89.26408703684696,6.035102124602278,4.700810838550754
11100101,11,10,01,01,3356,444,3127,2912,215,229,100.0,13.230035756853397,93.17640047675805,86.7699642431466,6.406436233611442,6.823599523241955
11100102,11,10,01,02,3095,1341,2107,1754,353,988,100.0,43.32794830371567,68.07754442649434,56.67205169628433,11.405492730210016,31.922455573505655
11100203,11,10,02,03,9394,3830,6857,5564,1293,2537,100.0,40.77070470513093,72.99340004258038,59.22929529486907,13.764104747711306,27.00659995741963
11100204,11,10,02,04,7463,3029,5419,4434,985,2044,100.0,40.58689535039529,72.61155031488677,59.41310464960472,13.198445665282058,27.388449685113226
11100205,11,10,02,05,6304,2468,4552,3836,716,1752,100.0,39.1497461928934,72.20812182741116,60.850253807106604,11.357868020304569,27.79187817258883
11100206,11,10,02,06,7807,2959,5659,4848,811,2148,100.0,37.90188292557961,72.48623030613552,62.09811707442039,10.388113231715128,27.513769693864482
11100307,11,10,03,07,11702,4133,9203,7569,1634,2499,100.0,35.318748931806525,78.64467612373953,64.68125106819346,13.963425055546061,21.355323876260467
11100308,11,10,03,08,9886,3756,7325,6130,1195,2561,100.0,37.99312158608133,74.09467934452762,62.00687841391868,12.087800930608942,25.905320655472387
11100309,11,10,03,09,6569,2149,5013,4420,593,1556,100.0,32.714263967118285,76.31298523367332,67.28573603288172,9.027249200791596,23.687014766326687
11200410,11,20,04,10,10413,3895,7540,6518,1022,2873,100.0,37.405166618649766,72.40948813982521,62.594833381350234,9.814654758474983,27.590511860174782
11200411,11,20,04,11,6917,2108,5491,4809,682,1426,100.0,30.475639728205874,79.38412606621368,69.52436027179412,9.859765794419546,20.615873933786325
11200512,11,20,05,12,3999,979,3259,3020,239,740,100.0,24.48112028007002,81.49537384346087,75.51887971992998,5.976494123530883,18.504626156539132
11200513,11,20,05,13,10466,3662,7732,6804,928,2734,100.0,34.98948977641888,73.87731702656221,65.01051022358112,8.866806802981081,26.1226829734378
11200514,11,20,05,14,16289,6259,12033,10030,2003,4256,100.0,38.42470378783228,73.87193811774817,61.57529621216772,12.296641905580454,26.128061882251824
11200515,11,20,05,15,5002,1803,3800,3199,601,1202,100.0,36.045581767293086,75.96961215513794,63.95441823270692,12.015193922431028,24.030387844862055
11300616,11,30,06,16,5992,2487,4500,3505,995,1492,100.0,41.50534045393858,75.10013351134846,58.49465954606141,16.60547396528705,24.899866488651533
11300617,11,30,06,17,4407,1536,3506,2871,635,901,100.0,34.853641933287946,79.55525300658044,65.14635806671205,14.408894939868391,20.44474699341956
11300618,11,30,06,18,3850,1440,2822,2410,412,1028,100.0,37.4025974025974,73.2987012987013,62.5974025974026,10.701298701298702,26.701298701298704
11300619,11,30,06,19,8889,3731,6228,5158,1070,2661,100.0,41.97322533468332,70.06412419844752,58.02677466531668,12.037349533130834,29.93587580155248
11300620,11,30,06,20,11346,4549,8416,6797,1619,2930,100.0,40.09342499559316,74.17592102943769,59.90657500440684,14.269346025030849,25.824078970562315
11300721,11,30,07,21,6848,4830,2550,2018,532,4298,100.0,70.53154205607477,37.237149532710276,29.468457943925237,7.768691588785047,62.762850467289724
11300722,11,30,07,22,10326,3290,8352,7036,1316,1974,100.0,31.861320937439473,80.88320743753631,68.13867906256053,12.744528374975788,19.116792562463683
11300723,11,30,07,23,2581,1784,1011,797,214,1570,100.0,69.12049593180937,39.170864006199146,30.87950406819062,8.291359938008522,60.829135993800854
11300724,11,30,07,24,4372,1550,3311,2822,489,1061,100.0,35.45288197621226,75.73193046660566,64.54711802378775,11.184812442817933,24.268069533394325
11300725,11,30,07,25,10202,3053,8105,7149,956,2097,100.0,29.92550480297981,79.44520682219172,70.0744951970202,9.370711625171534,20.55479317780827
11300826,11,30,08,26,10508,4712,7492,5796,1696,3016,100.0,44.84202512371526,71.29805862200229,55.15797487628473,16.140083745717547,28.701941377997713
11400927,11,40,09,27,4173,1178,3442,2995,447,731,100.0,28.229091780493647,82.48262640786005,71.77090821950635,10.711718188353704,17.517373592139947
11400928,11,40,09,28,2933,1324,1892,1609,283,1041,100.0,45.14149335151722,64.5073303784521,54.85850664848279,9.648823729969315,35.492669621547904
11400929,11,40,09,29,16901,5844,12634,11057,1577,4267,100.0,34.577835631027746,74.75297319685225,65.42216436897225,9.330808827880007,25.247026803147744
11400930,11,40,09,30,4760,1123,4062,3637,425,698,100.0,23.592436974789916,85.33613445378151,76.40756302521008,8.928571428571429,14.663865546218489
11400931,11,40,09,31,7064,2272,5547,4792,755,1517,100.0,32.16308040770102,78.52491506228766,67.83691959229898,10.687995469988675,21.475084937712342
11401032,11,40,10,32,6292,2676,4387,3616,771,1905,100.0,42.53019707565162,69.723458359822,57.46980292434838,12.253655435473618,30.276541640178007
11401033,11,40,10,33,6890,3069,4926,3821,1105,1964,100.0,44.542815674891145,71.49492017416546,55.457184325108855,16.037735849056602,28.505079825834546
11401034,11,40,10,34,3379,1318,2448,2061,387,931,100.0,39.00562296537437,72.44746966558154,60.99437703462562,11.453092630955904,27.552530334418467
11401135,11,40,11,35,11011,4263,8288,6748,1540,2723,100.0,38.71582962492053,75.27018436109346,61.28417037507946,13.986013986013987,24.72981563890655
11401136,11,40,11,36,8336,2645,6339,5691,648,1997,100.0,31.72984644913628,76.0436660268714,68.27015355086372,7.773512476007678,23.9563339731286
11401137,11,40,11,37,9004,3695,6585,5309,1276,2419,100.0,41.03731674811195,73.13416259440248,58.96268325188805,14.171479342514438,26.865837405597514
11501238,11,50,12,38,4899,1580,3979,3319,660,920,100.0,32.25147989385589,81.2206572769953,67.7485201061441,13.472137170851195,18.779342723004692
11501339,11,50,13,39,10574,3119,8423,7455,968,2151,100.0,29.496879137507094,79.65765084168716,70.5031208624929,9.15452997919425,20.342349158312842
11501340,11,50,13,40,11246,2295,9828,8951,877,1418,100.0,20.407255913213586,87.39107238129112,79.59274408678641,7.798328294504713,12.608927618708874
11501341,11,50,13,41,10103,3433,7656,6670,986,2447,100.0,33.98000593883005,75.7794714441255,66.01999406116995,9.759477382955557,24.220528555874495
12100101,12,10,01,01,11188,6735,7119,4453,2666,4069,100.0,60.19842688594923,63.630675723989995,39.80157311405077,23.82910260993922,36.36932427601001
12100102,12,10,01,02,9980,5515,6528,4465,2063,3452,100.0,55.260521042084164,65.41082164328658,44.73947895791583,20.671342685370742,34.58917835671343
12100103,12,10,01,03,7592,3812,5405,3780,1625,2187,100.0,50.21074815595363,71.19336143308746,49.78925184404637,21.404109589041095,28.80663856691254
12100204,12,10,02,04,9554,5258,6312,4296,2016,3242,100.0,55.0345405065941,66.06656897634498,44.9654594934059,21.101109482939084,33.93343102365501
12100205,12,10,02,05,13988,7291,9638,6697,2941,4350,100.0,52.12324849871318,68.90191592793823,47.87675150128682,21.025164426651415,31.098084072061766
12100206,12,10,02,06,4780,1960,3666,2820,846,1114,100.0,41.00418410041841,76.69456066945607,58.995815899581594,17.698744769874477,23.305439330543933
12200307,12,20,03,07,2804,1347,1916,1457,459,888,100.0,48.038516405135525,68.33095577746077,51.961483594864475,16.36947218259629,31.669044222539227
12200308,12,20,03,08,5868,2963,4178,2905,1273,1690,100.0,50.49420586230402,71.19972733469666,49.50579413769598,21.693933197000682,28.80027266530334
12200309,12,20,03,09,11286,6776,6858,4510,2348,4428,100.0,60.03898635477582,60.76555023923444,39.96101364522417,20.80453659401028,39.23444976076555
12200310,12,20,03,10,8284,5286,5016,2998,2018,3268,100.0,63.80975374215355,60.550458715596335,36.190246257846454,24.36021245774988,39.44954128440367
12200411,12,20,04,11,294,203,179,91,88,115,100.0,69.04761904761905,60.8843537414966,30.952380952380953,29.931972789115648,39.1156462585034
12200412,12,20,04,12,6518,2647,5007,3871,1136,1511,100.0,40.6106167536054,76.81804234427739,59.3893832463946,17.428659097882786,23.181957655722616
12200413,12,20,04,13,8103,3769,6033,4334,1699,2070,100.0,46.51363692459583,74.45390596075528,53.48636307540418,20.967542885351104,25.54609403924473
12200414,12,20,04,14,5440,4461,1193,979,214,4247,100.0,82.00367647058823,21.93014705882353,17.996323529411764,3.9338235294117645,78.06985294117646
12200515,12,20,05,15,11322,3432,9258,7890,1368,2064,100.0,30.312665606783252,81.77000529941706,69.68733439321674,12.082670906200319,18.229994700582935
12400616,12,40,06,16,6113,1181,5534,4932,602,579,100.0,19.319483068869623,90.52838213643057,80.68051693113037,9.84786520530018,9.471617863569442
12400617,12,40,06,17,6704,1053,6274,5651,623,430,100.0,15.707040572792364,93.58591885441527,84.29295942720763,9.292959427207636,6.414081145584725
12400618,12,40,06,18,3789,741,3465,3048,417,324,100.0,19.55661124307205,91.44893111638956,80.44338875692794,11.0055423594616,8.551068883610451
12400619,12,40,06,19,7726,1355,7094,6371,723,632,100.0,17.538182759513333,91.81982914833031,82.46181724048667,9.358011907843645,8.180170851669686
12400720,12,40,07,20,8480,1321,7925,7159,766,555,100.0,15.577830188679245,93.45518867924528,84.42216981132076,9.033018867924527,6.544811320754718
12400721,12,40,07,21,7891,1356,7259,6535,724,632,100.0,17.184133823343046,91.99087568115574,82.81586617665695,9.175009504498796,8.009124318844254
12400722,12,40,07,22,8517,1636,7655,6881,774,862,100.0,19.208641540448514,89.87906539861453,80.79135845955149,9.08770693906305,10.120934601385464
12400723,12,40,07,23,8090,1559,7324,6531,793,766,100.0,19.27070457354759,90.53152039555006,80.72929542645241,9.802224969097653,9.468479604449938
12500824,12,50,08,24,9681,2018,8656,7663,993,1025,100.0,20.844954033674206,89.41225080053712,79.15504596632579,10.257204834211342,10.587749199462865
12500825,12,50,08,25,7079,2563,5309,4516,793,1770,100.0,36.205678768187596,74.99646842774403,63.794321231812404,11.202147195931628,25.003531572255966
12500926,12,50,09,26,5181,1788,4135,3393,742,1046,100.0,34.510712217718584,79.8108473267709,65.48928778228141,14.321559544489482,20.189152673229106
12500927,12,50,09,27,6874,2139,5795,4735,1060,1079,100.0,31.11725341867908,84.30317137038115,68.88274658132092,15.420424789060228,15.696828629618853
12500928,12,50,09,28,5158,1266,4490,3892,598,668,100.0,24.544397053121365,87.04924389298178,75.45560294687863,11.593640946103141,12.950756107018224
12500929,12,50,09,29,5104,1040,4713,4064,649,391,100.0,20.37617554858934,92.33934169278997,79.62382445141067,12.71551724137931,7.660658307210031
12500930,12,50,09,30,9873,3857,7497,6016,1481,2376,100.0,39.06613997771701,75.93436645396537,60.93386002228299,15.000506431682368,24.06563354603464
12601031,12,60,10,31,3333,1189,2745,2144,601,588,100.0,35.673567356735674,82.35823582358236,64.32643264326433,18.031803180318033,17.64176417641764
12601032,12,60,10,32,6250,3626,4030,2624,1406,2220,100.0,58.016,64.48,41.984,22.496,35.52
12601133,12,60,11,33,11448,6280,8329,5168,3161,3119,100.0,54.85674353598882,72.75506638714185,45.14325646401118,27.611809923130675,27.24493361285814
12601134,12,60,11,34,16006,8249,11749,7757,3992,4257,100.0,51.536923653629884,73.40372360364863,48.46307634637011,24.94064725727852,26.59627639635137
12601235,12,60,12,35,10610,6471,7285,4139,3146,3325,100.0,60.98963242224317,68.66163996229972,39.01036757775683,29.65127238454288,31.33836003770028
12601236,12,60,12,36,3190,1529,2530,1661,869,660,100.0,47.93103448275862,79.3103448275862,52.06896551724138,27.241379310344826,20.689655172413794
