id,district_id,forecast_area_id,district_region_id,planning_area_id,inhabitants,inhabitants_with_migration_background,inhabitants_germans,inhabitants_germans_without_migration_background,inhabitants_germans_with_migration_background,inhabitants_foreigners,inhabitants_percentage,inhabitants_with_migration_background_percentage,inhabitants_germans_percentage,inhabitants_germans_without_migration_background_percentage,inhabitants_germans_with_migration_background_percentage,inhabitants_foreigners_percentage
01011101,01,01,11,01,3187,1841,1911,1346,565,1276,100.0,57.765924066520235,59.96234703482899,42.23407593347976,17.72827110134923,40.037652965171006
01011102,01,01,11,02,188,76,124,112,12,64,100.0,40.42553191489361,65.95744680851064,59.57446808510638,6.382978723404255,34.04255319148936
01011103,01,01,11,03,5192,2924,3358,2268,1090,1834,100.0,56.31741140215717,64.6764252696456,43.68258859784284,20.993836671802775,35.32357473035439
01011104,01,01,11,04,4685,3000,2892,1685,1207,1793,100.0,64.03415154749199,61.72892209178228,35.965848452508006,25.763073639274282,38.27107790821771
01011105,01,01,11,05,1180,707,688,473,215,492,100.0,59.91525423728814,58.30508474576271,40.08474576271187,18.220338983050848,41.69491525423729
01011201,01,01,12,01,2236,1212,1435,1024,411,801,100.0,54.203935599284435,64.17710196779964,45.796064400715565,18.38103756708408,35.82289803220036
01011202,01,01,12,02,620,300,385,320,65,235,100.0,48.38709677419355,62.096774193548384,51.61290322580645,10.483870967741936,37.903225806451616
01011203,01,01,12,03,1039,541,646,498,148,393,100.0,52.06929740134745,62.175168431183835,47.93070259865255,14.244465832531281,37.82483156881617
01011204,01,01,12,04,7707,3515,5381,4192,1189,2326,100.0,45.60788893213961,69.81964447904502,54.392111067860384,15.427533411184639,30.180355520954976
01011301,01,01,13,01,6611,2702,4671,3909,762,1940,100.0,40.87127514748147,70.65496899107548,59.12872485251853,11.52624413855695,29.345031008924522
01011302,01,01,13,02,12604,4780,9308,7824,1484,3296,100.0,37.924468422722946,73.84957156458267,62.075531577277054,11.774039987305617,26.15042843541733
01011303,01,01,13,03,9580,4252,6457,5328,1129,3123,100.0,44.38413361169103,67.4008350730689,55.61586638830897,11.784968684759917,32.59916492693111
01011304,01,01,13,04,8598,3140,6604,5458,1146,1994,100.0,36.52012095836241,76.80856013026285,63.47987904163759,13.32868108862526,23.19143986973715
01011305,01,01,13,05,7752,2744,5941,5008,933,1811,100.0,35.39731682146543,76.63828689370486,64.60268317853458,12.035603715170279,23.36171310629515
01011306,01,01,13,06,9983,4101,7178,5882,1296,2805,100.0,41.079835720725235,71.90223379745568,58.920164279274765,12.982069518180909,28.097766202544328
01011401,01,01,14,01,16720,6633,11919,10087,1832,4801,100.0,39.671052631578945,71.28588516746412,60.32894736842105,10.956937799043063,28.714114832535888
01011402,01,01,14,02,13423,5026,9954,8397,1557,3469,100.0,37.44319451687402,74.15629888996499,62.55680548312598,11.599493406839008,25.843701110035017
01022101,01,02,21,01,3577,1876,2294,1701,593,1283,100.0,52.44618395303326,64.13195415152362,47.55381604696673,16.578138104556892,35.86804584847638
01022102,01,02,21,02,6446,3801,3829,2645,1184,2617,100.0,58.966801116971766,59.401179025752405,41.033198883028234,18.367980142724168,40.598820974247595
01022103,01,02,21,03,252,180,124,72,52,128,100.0,71.42857142857143,49.2063492063492,28.57142857142857,20.634920634920633,50.79365079365079
01022104,01,02,21,04,18617,9065,12742,9552,3190,5875,100.0,48.6920556480636,68.4428210775098,51.307944351936406,17.1348767255734,31.5571789224902
01022105,01,02,21,05,5361,3097,3393,2264,1129,1968,100.0,57.769072934154075,63.29043088975938,42.230927065845925,21.05950382391345,36.70956911024062
01022106,01,02,21,06,11788,4222,9183,7566,1617,2605,100.0,35.816084153376316,77.90125551408211,64.18391584662369,13.717339667458434,22.09874448591788
01022201,01,02,22,01,11200,5572,7691,5628,2063,3509,100.0,49.75,68.66964285714286,50.24999999999999,18.419642857142858,31.33035714285714
01022202,01,02,22,02,1517,975,1017,542,475,500,100.0,64.27158866183257,67.04021094264996,35.72841133816744,31.31179960448253,32.95978905735003
01022203,01,02,22,03,7022,4102,4665,2920,1745,2357,100.0,58.41640558245514,66.4340643691256,41.58359441754486,24.85046995158075,33.56593563087439
01022204,01,02,22,04,5896,2397,4405,3499,906,1491,100.0,40.654681139755766,74.71166892808684,59.345318860244234,15.366350067842605,25.288331071913163
01022205,01,02,22,05,3296,1972,2273,1324,949,1023,100.0,59.83009708737864,68.9623786407767,40.16990291262136,28.792475728155342,31.0376213592233
01022206,01,02,22,06,3016,1198,2366,1818,548,650,100.0,39.721485411140584,78.44827586206897,60.27851458885941,18.169761273209552,21.551724137931032
01022207,01,02,22,07,5673,2497,3898,3176,722,1775,100.0,44.01551207474,68.71144015512075,55.984487925260005,12.726952229860744,31.288559844879256
01033101,01,03,31,01,26804,16527,15882,10277,5605,10922,100.0,61.6587076555738,59.25235039546336,38.3412923444262,20.91105805103716,40.74764960453663
01033102,01,03,31,02,12061,7337,7374,4724,2650,4687,100.0,60.83243512146588,61.13920902081088,39.167564878534115,21.971644142276762,38.86079097918912
01033201,01,03,32,01,13275,8765,9244,4510,4734,4031,100.0,66.02636534839925,69.6346516007533,33.973634651600754,35.66101694915254,30.365348399246706
01033202,01,03,32,02,9766,5404,7155,4362,2793,2611,100.0,55.33483514233053,73.26438664755274,44.66516485766947,28.599221789883266,26.735613352447267
01033203,01,03,32,03,14478,9108,8783,5370,3413,5695,100.0,62.9092416079569,60.66445641663213,37.0907583920431,23.57369802458903,39.335543583367865
01044101,01,04,41,01,20653,9705,14427,10948,3479,6226,100.0,46.990751948869416,69.85425846124049,53.009248051130584,16.84501041010991,30.145741538759502
01044102,01,04,41,02,16322,6263,12561,10059,2502,3761,100.0,38.3715230976596,76.9574807008945,61.6284769023404,15.3290037985541,23.0425192991055
01044103,01,04,41,03,8575,4435,5489,4140,1349,3086,100.0,51.72011661807581,64.01166180758018,48.2798833819242,15.731778425655977,35.988338192419825
01044201,01,04,42,01,23791,16034,13531,7757,5774,10260,100.0,67.3952334916565,56.87444832079358,32.60476650834349,24.269681812450088,43.125551679206424
01044202,01,04,42,02,16719,9582,10021,7137,2884,6698,100.0,57.31204019379149,59.93779532268676,42.687959806208504,17.24983551647826,40.06220467731323
01044203,01,04,42,03,16534,9602,10064,6932,3132,6470,100.0,58.07427119874199,60.86851336639651,41.92572880125802,18.942784565138503,39.13148663360349
02010101,02,01,01,01,6291,4406,3655,1885,1770,2636,100.0,70.03656016531554,58.09887140359243,29.96343983468447,28.135431568907965,41.90112859640757
02010102,02,01,01,02,13323,8967,9009,4356,4653,4314,100.0,67.30466111236208,67.6199054267057,32.695338887637924,34.924566539067776,32.38009457329431
02010103,02,01,01,03,15477,10704,10024,4773,5251,5453,100.0,69.16069005621245,64.76707372229761,30.83930994378756,33.92776377851005,35.2329262777024
02010104,02,01,01,04,5068,3271,3419,1797,1622,1649,100.0,64.54222573007104,67.46250986582479,35.45777426992897,32.004735595895816,32.537490134175215
02020201,02,02,02,01,953,471,677,482,195,276,100.0,49.422875131164744,71.03882476390346,50.577124868835256,20.461699895068204,28.961175236096537
02020202,02,02,02,02,5939,2513,4299,3426,873,1640,100.0,42.31352079474659,72.38592355615422,57.686479205253406,14.699444350900826,27.614076443845764
02020203,02,02,02,03,10895,4137,8354,6758,1596,2541,100.0,37.97154658100046,76.67737494263423,62.02845341899954,14.648921523634694,23.322625057365766
02020204,02,02,02,04,12377,5091,9147,7286,1861,3230,100.0,41.13274622283267,73.90320756241415,58.86725377716733,15.035953785246829,26.096792437585847
02020205,02,02,02,05,14834,5795,11319,9039,2280,3515,100.0,39.06565997033841,76.30443575569637,60.93434002966159,15.370095726034785,23.695564244303625
02020206,02,02,02,06,18943,8472,13807,10471,3336,5136,100.0,44.723644618064725,72.88708229953016,55.27635538193528,17.610726917594892,27.11291770046983
02030301,02,03,03,01,9075,5651,5645,3424,2221,3430,100.0,62.269972451790636,62.20385674931129,37.730027548209364,24.47382920110193,37.79614325068871
02030302,02,03,03,02,13162,6963,8889,6199,2690,4273,100.0,52.90229448412096,67.53532897735907,47.09770551587905,20.43762346148002,32.464671022640935
02030401,02,03,04,01,15161,7205,10407,7956,2451,4754,100.0,47.523250445221294,68.64322933843414,52.47674955477871,16.166479783655433,31.356770661565857
02030402,02,03,04,02,11081,5445,7517,5636,1881,3564,100.0,49.13816442559336,67.83683783052071,50.86183557440664,16.97500225611407,32.163162169479286
02040501,02,04,05,01,5428,1345,4651,4083,568,777,100.0,24.778924097273396,85.68533529845247,75.2210759027266,10.464259395725865,14.31466470154753
02040502,02,04,05,02,7209,1884,6017,5325,692,1192,100.0,26.133999167707035,83.46511305312804,73.86600083229297,9.599112220835067,16.534886946871964
02040503,02,04,05,03,11003,2601,9271,8402,869,1732,100.0,23.639007543397256,84.25883849859129,76.36099245660274,7.897846041988549,15.741161501408707
02040701,02,04,07,01,12374,4483,9439,7891,1548,2935,100.0,36.229190237594956,76.28091158881526,63.770809762405044,12.510101826410214,23.719088411184742
02040702,02,04,07,02,10709,2506,9022,8203,819,1687,100.0,23.40087776636474,84.24689513493323,76.59912223363527,7.647772901297974,15.753104865066767
02040703,02,04,07,03,1165,788,479,377,102,686,100.0,67.63948497854078,41.11587982832618,32.36051502145923,8.755364806866952,58.884120171673814
02050601,02,05,06,01,8955,2579,7120,6376,744,1835,100.0,28.79955332216639,79.50865438302624,71.20044667783361,8.30820770519263,20.491345616973756
02050602,02,05,06,02,21272,5859,17177,15413,1764,4095,100.0,27.54324934185784,80.7493418578413,72.45675065814216,8.292591199699135,19.250658142158706
02050801,02,05,08,01,19214,6028,14800,13186,1614,4414,100.0,31.3729572186947,77.02716769022587,68.6270427813053,8.400124908920578,22.972832309774123
02050802,02,05,08,02,20487,5886,16148,14601,1547,4339,100.0,28.7304144091375,78.82071557573094,71.26958559086249,7.551129984868453,21.17928442426905
02050803,02,05,08,03,7142,2110,5668,5032,636,1474,100.0,29.543545225427053,79.36152338280593,70.45645477457295,8.905068608232988,20.638476617194062
02050804,02,05,08,04,4323,953,3776,3370,406,547,100.0,22.044876243349528,87.3467499421698,77.95512375665048,9.391626185519316,12.65325005783021
03010101,03,01,01,01,3971,463,3670,3508,162,301,100.0,11.659531604129942,92.42004532863258,88.34046839587005,4.079576932762528,7.579954671367414
03010102,03,01,01,02,11774,1594,10622,10180,442,1152,100.0,13.538304739255988,90.21572957363682,86.46169526074401,3.754034312892815,9.784270426363173
03010104,03,01,01,04,231,46,200,185,15,31,100.0,19.913419913419915,86.58008658008657,80.08658008658008,6.493506493506493,13.41991341991342
03020203,03,02,02,03,2086,91,2055,1995,60,31,100.0,4.3624161073825505,98.51390220517737,95.63758389261746,2.876318312559923,1.486097794822627
03020209,03,02,02,09,14849,2094,13597,12755,842,1252,100.0,14.101959727927808,91.56845578826857,85.8980402720722,5.6704155161963765,8.43154421173143
03020210,03,02,02,10,11157,1368,10389,9789,600,768,100.0,12.261360580801291,93.11642914762032,87.7386394191987,5.377789728421619,6.883570852379672
03020307,03,02,03,07,18157,2106,17331,16051,1280,826,100.0,11.59883240623451,95.4507903287988,88.40116759376549,7.04962273503332,4.54920967120119
03030405,03,03,04,05,11240,1591,10326,9649,677,914,100.0,14.154804270462634,91.86832740213524,85.84519572953737,6.023131672597865,8.131672597864767
03030406,03,03,04,06,8231,582,7962,7649,313,269,100.0,7.070829789818978,96.7318673308225,92.92917021018103,3.8026971206414775,3.2681326691774997
03030711,03,03,07,11,6825,379,6656,6446,210,169,100.0,5.553113553113553,97.52380952380952,94.44688644688645,3.076923076923077,2.4761904761904763
03030715,03,03,07,15,7408,1212,6555,6196,359,853,100.0,16.360691144708422,88.4854211663067,83.63930885529157,4.846112311015119,11.514578833693305
03030716,03,03,07,16,1142,36,1120,1106,14,22,100.0,3.1523642732049035,98.07355516637479,96.8476357267951,1.2259194395796849,1.926444833625219
03040508,03,04,05,08,4597,887,4316,3710,606,281,100.0,19.295192516858823,93.88731781596692,80.70480748314118,13.182510332825755,6.112682184033065
03040512,03,04,05,12,9791,1300,9203,8491,712,588,100.0,13.277499744663466,93.9944847308753,86.72250025533653,7.27198447553876,6.0055152691247065
03040513,03,04,05,13,3413,455,3189,2958,231,224,100.0,13.331380017579841,93.43685906826839,86.66861998242015,6.768239085848228,6.563140931731615
03040614,03,04,06,14,35544,4544,32961,31000,1961,2583,100.0,12.784154850326356,92.73295070898043,87.21584514967364,5.517105559306774,7.267049291019581
03040818,03,04,08,18,34281,4922,31057,29359,1698,3224,100.0,14.357807531868966,90.59537353052711,85.64219246813104,4.953181062396079,9.404626469472886
03050919,03,05,09,19,5451,938,4683,4513,170,768,100.0,17.207851770317372,85.91084204733076,82.79214822968262,3.118693817648138,14.089157952669234
03050920,03,05,09,20,7404,960,6831,6444,387,573,100.0,12.965964343598054,92.26094003241491,87.03403565640194,5.226904376012966,7.7390599675850895
03050923,03,05,09,23,9227,1721,8059,7506,553,1168,100.0,18.65178281131462,87.34149777825945,81.34821718868538,5.993280589574076,12.658502221740545
03050924,03,05,09,24,5869,1206,4996,4663,333,873,100.0,20.548645425115012,85.12523428181973,79.45135457488499,5.673879706934741,14.874765718180269
03050925,03,05,09,25,9635,1543,8628,8092,536,1007,100.0,16.014530358069536,89.54852101712505,83.98546964193046,5.563051375194603,10.451478982874935
03051017,03,05,10,17,4244,781,3671,3463,208,573,100.0,18.40245051837889,86.49858623939679,81.59754948162112,4.9010367577756835,13.501413760603203
03051021,03,05,10,21,6477,661,5998,5816,182,479,100.0,10.20534197931141,92.6046008954763,89.79465802068859,2.80994287478771,7.395399104523699
03051022,03,05,10,22,4536,285,4375,4251,124,161,100.0,6.283068783068783,96.4506172839506,93.71693121693121,2.7336860670194003,3.5493827160493825
03061126,03,06,11,26,15167,3962,12414,11205,1209,2753,100.0,26.122502802136218,81.8487505769104,73.87749719786379,7.971253379046614,18.151249423089602
03061131,03,06,11,31,10543,3346,8190,7197,993,2353,100.0,31.73669733472446,77.68187422934648,68.26330266527553,9.418571564070948,22.318125770653513
03061227,03,06,12,27,14534,3427,12246,11107,1139,2288,100.0,23.579193614971793,84.25760286225402,76.4208063850282,7.836796477225816,15.742397137745975
03061228,03,06,12,28,12592,2636,10793,9956,837,1799,100.0,20.933926302414232,85.71315120711563,79.06607369758576,6.6470775095298595,14.28684879288437
03061332,03,06,13,32,22619,6557,18237,16062,2175,4382,100.0,28.98890313453292,80.62690658296123,71.01109686546708,9.615809717494143,19.373093417038774
03061429,03,06,14,29,10047,1336,9192,8711,481,855,100.0,13.297501741813477,91.48999701403405,86.70249825818652,4.787498755847517,8.51000298596596
03061430,03,06,14,30,3840,1372,2668,2468,200,1172,100.0,35.729166666666664,69.47916666666667,64.27083333333333,5.208333333333334,30.520833333333336
03061434,03,06,14,34,6301,1477,5286,4824,462,1015,100.0,23.440723694651645,83.8914458022536,76.55927630534836,7.332169496905252,16.10855419774639
03061435,03,06,14,35,3893,978,3215,2915,300,678,100.0,25.1220138710506,82.58412535319805,74.87798612894939,7.706139224248651,17.415874646801953
03061441,03,06,14,41,2545,619,2232,1926,306,313,100.0,24.32220039292731,87.70137524557957,75.6777996070727,12.023575638506877,12.298624754420432
03071536,03,07,15,36,10701,3616,8246,7085,1161,2455,100.0,33.79123446406878,77.05821885805065,66.20876553593122,10.849453322119427,22.94178114194935
03071537,03,07,15,37,15606,5124,12010,10482,1528,3596,100.0,32.83352556708958,76.95758041778802,67.16647443291042,9.79110598487761,23.04241958221197
03071633,03,07,16,33,3086,805,2570,2281,289,516,100.0,26.08554763447829,83.27932598833442,73.91445236552171,9.364873622812702,16.720674011665587
03071638,03,07,16,38,17336,5117,13922,12219,1703,3414,100.0,29.51661282879557,80.3068758652515,70.48338717120443,9.82348869404707,19.693124134748498
03071639,03,07,16,39,12382,3075,10408,9307,1101,1974,100.0,24.834437086092713,84.0575028266839,75.16556291390728,8.89193991277661,15.942497173316102
04010101,04,01,01,01,10598,4706,7939,5892,2047,2659,100.0,44.40460464238535,74.91036044536705,55.59539535761464,19.314965087752405,25.089639554632946
04010102,04,01,01,02,1055,513,591,542,49,464,100.0,48.62559241706161,56.018957345971565,51.37440758293839,4.644549763033176,43.981042654028435
04010103,04,01,01,03,7846,4074,5834,3772,2062,2012,100.0,51.92454754014785,74.35635992862605,48.07545245985215,26.280907468773897,25.643640071373948
04020204,04,02,02,04,179,64,138,115,23,41,100.0,35.754189944134076,77.09497206703911,64.24581005586593,12.849162011173185,22.905027932960895
04020205,04,02,02,05,1342,349,1133,993,140,209,100.0,26.005961251862892,84.42622950819673,73.99403874813711,10.432190760059612,15.573770491803279
04020206,04,02,02,06,2778,646,2396,2132,264,382,100.0,23.254139668826493,86.24910007199425,76.7458603311735,9.503239740820735,13.750899928005762
04020207,04,02,02,07,2553,711,2141,1842,299,412,100.0,27.84958871915394,83.86212299255777,72.15041128084606,11.711711711711711,16.137877007442224
04020208,04,02,02,08,2916,752,2502,2164,338,414,100.0,25.788751714677637,85.80246913580247,74.21124828532236,11.59122085048011,14.19753086419753
04020209,04,02,02,09,3207,1178,2318,2029,289,889,100.0,36.73214842531961,72.27938883691924,63.26785157468039,9.011537262238853,27.72061116308076
04020310,04,02,03,10,621,318,353,303,50,268,100.0,51.20772946859904,56.84380032206119,48.792270531400966,8.051529790660226,43.15619967793881
04020311,04,02,03,11,14848,4609,12042,10239,1803,2806,100.0,31.041217672413797,81.10183189655173,68.9587823275862,12.143049568965516,18.898168103448278
04020312,04,02,03,12,5516,1717,4431,3799,632,1085,100.0,31.127628716461203,80.32994923857868,68.8723712835388,11.457577955039884,19.670050761421322
04020313,04,02,03,13,7596,3001,5634,4595,1039,1962,100.0,39.50763559768299,74.17061611374407,60.49236440231701,13.678251711427066,25.829383886255926
04020314,04,02,03,14,329,329,3,0,3,326,100.0,100.0,0.911854103343465,0.0,0.911854103343465,99.08814589665653
04030415,04,03,04,15,2932,1491,1813,1441,372,1119,100.0,50.85266030013642,61.83492496589359,49.14733969986357,12.687585266030013,38.16507503410641
04030416,04,03,04,16,10670,5121,7708,5549,2159,2962,100.0,47.99437675726336,72.23992502343017,52.00562324273664,20.234301780693535,27.760074976569822
04030417,04,03,04,17,10950,4068,8476,6882,1594,2474,100.0,37.15068493150685,77.40639269406392,62.84931506849315,14.557077625570777,22.59360730593607
04030518,04,03,05,18,9411,4052,6979,5359,1620,2432,100.0,43.05599829986186,74.15790032940176,56.94400170013814,17.21389862926363,25.842099670598234
04030519,04,03,05,19,5759,2530,4238,3229,1009,1521,100.0,43.93123806216357,73.58916478555305,56.06876193783643,17.520402847716618,26.410835214446955
04030620,04,03,06,20,8714,3772,6511,4942,1569,2203,100.0,43.28666513656185,74.71884324076198,56.71333486343815,18.00550837732385,25.28115675923801
04030621,04,03,06,21,3029,1637,2008,1392,616,1021,100.0,54.04423902277979,66.29250577748432,45.95576097722021,20.336744800264114,33.707494222515685
04030622,04,03,06,22,10588,4835,7732,5753,1979,2856,100.0,45.66490366452588,73.02606724593879,54.33509633547412,18.690970910464678,26.973932754061202
04030623,04,03,06,23,4890,2688,3332,2202,1130,1558,100.0,54.969325153374236,68.13905930470348,45.030674846625764,23.108384458077712,31.860940695296524
04030724,04,03,07,24,6509,2344,5071,4165,906,1438,100.0,36.01167614072822,77.90751267475802,63.98832385927178,13.91918881548625,22.092487325241972
04030725,04,03,07,25,12258,4852,9045,7406,1639,3213,100.0,39.58231359112416,73.7885462555066,60.41768640887584,13.370859846630772,26.21145374449339
04030726,04,03,07,26,5560,2360,4109,3200,909,1451,100.0,42.44604316546763,73.90287769784173,57.55395683453237,16.348920863309353,26.097122302158272
04030827,04,03,08,27,12311,6459,8052,5852,2200,4259,100.0,52.46527495735521,65.40492242709772,47.53472504264479,17.87019738445293,34.595077572902284
04030828,04,03,08,28,9577,4187,6859,5390,1469,2718,100.0,43.719327555601964,71.61950506421636,56.280672444398036,15.338832619818316,28.380494935783645
04030929,04,03,09,29,6027,2571,4388,3456,932,1639,100.0,42.65803882528621,72.80570764891323,57.34196117471379,15.463746474199436,27.194292351086773
04030930,04,03,09,30,5619,2472,4026,3147,879,1593,100.0,43.99359316604378,71.64975974372663,56.00640683395623,15.643352909770423,28.350240256273356
04030931,04,03,09,31,4014,2349,2331,1665,666,1683,100.0,58.52017937219731,58.07174887892377,41.47982062780269,16.591928251121075,41.92825112107623
04031032,04,03,10,32,15076,6032,11530,9044,2486,3546,100.0,40.01061289466702,76.47917219421598,59.98938710533298,16.489785088882993,23.520827805784027
04041133,04,04,11,33,39,12,36,27,9,3,100.0,30.76923076923077,92.3076923076923,69.23076923076923,23.076923076923077,7.6923076923076925
04041134,04,04,11,34,5235,2032,4072,3203,869,1163,100.0,38.81566380133715,77.78414517669532,61.18433619866285,16.599808978032474,22.215854823304678
04041135,04,04,11,35,2762,908,2251,1854,397,511,100.0,32.87472845763939,81.49891383055757,67.12527154236061,14.373642288196958,18.50108616944243
04041136,04,04,11,36,3038,979,2480,2059,421,558,100.0,32.225148123765635,81.63265306122449,67.77485187623437,13.857801184990127,18.367346938775512
04041137,04,04,11,37,8053,2826,6508,5227,1281,1545,100.0,35.09251210728921,80.81460325344591,64.90748789271079,15.90711536073513,19.18539674655408
04041238,04,04,12,38,5972,1940,5015,4032,983,957,100.0,32.484929671801744,83.97521768251842,67.51507032819826,16.460147354320164,16.02478231748158
04041239,04,04,12,39,195,101,116,94,22,79,100.0,51.7948717948718,59.48717948717949,48.205128205128204,11.282051282051283,40.51282051282051
04041240,04,04,12,40,1511,385,1311,1126,185,200,100.0,25.479814692256785,86.76373262739907,74.52018530774322,12.243547319655857,13.236267372600926
04041241,04,04,12,41,6976,1630,6083,5346,737,893,100.0,23.365825688073393,87.19896788990825,76.6341743119266,10.564793577981652,12.801032110091743
04041342,04,04,13,42,4132,1313,3409,2819,590,723,100.0,31.776379477250728,82.50242013552759,68.22362052274927,14.278799612778315,17.49757986447241
04041343,04,04,13,43,3524,1043,2977,2481,496,547,100.0,29.59704880817253,84.47786606129398,70.40295119182747,14.074914869466514,15.522133938706014
04041344,04,04,13,44,10683,2780,9019,7903,1116,1664,100.0,26.022652812880274,84.42385097818965,73.97734718711972,10.446503791069924,15.576149021810354
04051445,04,05,14,45,6279,2585,4830,3694,1136,1449,100.0,41.16897595158465,76.92307692307693,58.83102404841535,18.092052874661572,23.076923076923077
04051446,04,05,14,46,10630,4427,8065,6203,1862,2565,100.0,41.64628410159924,75.87017873941674,58.35371589840075,17.516462841015993,24.129821260583256
04051447,04,05,14,47,5268,2083,4001,3185,816,1267,100.0,39.54062262718299,75.94912680334093,60.459377372817016,15.489749430523919,24.050873196659072
04051448,04,05,14,48,9146,4122,6540,5024,1516,2606,100.0,45.06888257161601,71.50666958233107,54.93111742838399,16.575552153947083,28.49333041766893
04051549,04,05,15,49,5312,2651,3371,2661,710,1941,100.0,49.9058734939759,63.460090361445786,50.0941265060241,13.365963855421686,36.53990963855422
04051550,04,05,15,50,5569,2159,4291,3410,881,1278,100.0,38.76818100197522,77.05153528461123,61.23181899802478,15.819716286586461,22.94846471538876
04051551,04,05,15,51,4444,1808,3388,2636,752,1056,100.0,40.68406840684069,76.23762376237624,59.31593159315932,16.92169216921692,23.762376237623762
04051652,04,05,16,52,9736,3651,7441,6085,1356,2295,100.0,37.5,76.42769104354971,62.5,13.92769104354971,23.57230895645029
04051653,04,05,16,53,6851,2770,5161,4081,1080,1690,100.0,40.432053714786164,75.33206831119544,59.567946285213836,15.764122025981608,24.667931688804554
04051654,04,05,16,54,3035,1078,2379,1957,422,656,100.0,35.518945634266885,78.38550247116969,64.48105436573312,13.904448105436574,21.614497528830313
04051655,04,05,16,55,7016,2901,5296,4115,1181,1720,100.0,41.348346636259976,75.48460661345496,58.65165336374002,16.832953249714937,24.51539338654504
04051656,04,05,16,56,7648,2376,6237,5272,965,1411,100.0,31.066945606694564,81.55073221757321,68.93305439330544,12.617677824267782,18.44926778242678
04061757,04,06,17,57,73,19,57,54,3,16,100.0,26.027397260273972,78.08219178082192,73.97260273972603,4.10958904109589,21.91780821917808
05010101,05,01,01,01,10826,3255,8937,7571,1366,1889,100.0,30.06650655828561,82.55126547201182,69.93349344171439,12.617772030297433,17.448734527988176
05010102,05,01,01,02,5915,1303,5149,4612,537,766,100.0,22.028740490278953,87.04987320371936,77.97125950972105,9.07861369399831,12.950126796280642
05010103,05,01,01,03,7654,1255,7058,6399,659,596,100.0,16.396655343611183,92.21322184478704,83.60334465638881,8.609877188398222,7.786778155212961
05010204,05,01,02,04,3339,1270,2731,2069,662,608,100.0,38.03533992213238,81.79095537586105,61.96466007786763,19.82629529799341,18.209044624138965
05010205,05,01,02,05,1925,523,1731,1402,329,194,100.0,27.16883116883117,89.92207792207793,72.83116883116884,17.09090909090909,10.077922077922077
05010206,05,01,02,06,10395,3705,8608,6690,1918,1787,100.0,35.64213564213564,82.80904280904281,64.35786435786436,18.45117845117845,17.19095719095719
05010207,05,01,02,07,11508,5642,9064,5866,3198,2444,100.0,49.02676399026764,78.76259993048315,50.97323600973236,27.78936392075078,21.237400069516855
05010208,05,01,02,08,7675,2470,6251,5205,1046,1424,100.0,32.182410423452765,81.44625407166124,67.81758957654723,13.628664495114007,18.553745928338763
05010209,05,01,02,09,6102,1769,5314,4333,981,788,100.0,28.990494919698463,87.08620124549327,71.00950508030154,16.07669616519174,12.91379875450672
05010310,05,01,03,10,3927,1329,3149,2598,551,778,100.0,33.84262796027502,80.18843901196843,66.15737203972498,14.031066972243442,19.811560988031577
05010311,05,01,03,11,5655,2876,4165,2779,1386,1490,100.0,50.85764809902741,73.65163572060123,49.14235190097259,24.509283819628646,26.348364279398762
05010312,05,01,03,12,7147,3715,4546,3432,1114,2601,100.0,51.9798516860221,63.60710787743109,48.0201483139779,15.586959563453199,36.39289212256891
05010313,05,01,03,13,6734,2611,5144,4123,1021,1590,100.0,38.773388773388774,76.38847638847639,61.226611226611226,15.161865161865162,23.61152361152361
05010314,05,01,03,14,12098,4507,9609,7591,2018,2489,100.0,37.254091585386014,79.42635146305174,62.74590841461398,16.680443048437755,20.573648536948255
05010339,05,01,03,39,1014,685,388,329,59,626,100.0,67.55424063116371,38.26429980276134,32.44575936883629,5.818540433925049,61.735700197238664
05020415,05,02,04,15,3906,736,3707,3170,537,199,100.0,18.842805939580135,94.905273937532,81.15719406041987,13.748079877112135,5.094726062467998
05020416,05,02,04,16,1710,94,1677,1616,61,33,100.0,5.497076023391813,98.0701754385965,94.50292397660819,3.5672514619883042,1.9298245614035088
05020417,05,02,04,17,5930,1716,5053,4214,839,877,100.0,28.93760539629005,85.21079258010118,71.06239460370995,14.14839797639123,14.789207419898819
05020418,05,02,04,18,4066,760,3707,3306,401,359,100.0,18.69158878504673,91.1706837186424,81.30841121495327,9.862272503689129,8.829316281357599
05020419,05,02,04,19,7051,1723,6205,5328,877,846,100.0,24.43625017727982,88.00170188625727,75.56374982272018,12.437952063537088,11.998298113742733
05020420,05,02,04,20,949,172,885,777,108,64,100.0,18.124341412012647,93.25605900948368,81.87565858798736,11.380400421496311,6.743940990516332
05020521,05,02,05,21,3174,828,2880,2346,534,294,100.0,26.08695652173913,90.73724007561437,73.91304347826086,16.824196597353495,9.262759924385634
05020522,05,02,05,22,7412,3306,5327,4106,1221,2085,100.0,44.60334592552617,71.86994063680518,55.39665407447383,16.473286562331353,28.13005936319482
05020523,05,02,05,23,12513,6862,9152,5651,3501,3361,100.0,54.83896747382722,73.13993446815313,45.161032526172775,27.97890194198034,26.860065531846878
05020524,05,02,05,24,6122,1063,5650,5059,591,472,100.0,17.363606664488728,92.29010127409344,82.63639333551127,9.653707938582162,7.709898725906567
05020625,05,02,06,25,7545,2439,6202,5106,1096,1343,100.0,32.32604373757455,82.20013253810471,67.67395626242545,14.526176275679259,17.799867461895293
05020626,05,02,06,26,19249,6879,14700,12370,2330,4549,100.0,35.73692139851421,76.36760351187075,64.26307860148579,12.104524910384955,23.632396488129253
05020627,05,02,06,27,4226,1697,3242,2529,713,984,100.0,40.156176053005204,76.71557027922385,59.84382394699479,16.87174633222906,23.28442972077615
05020628,05,02,06,28,1999,443,1794,1556,238,205,100.0,22.161080540270135,89.7448724362181,77.83891945972987,11.905952976488244,10.25512756378189
05020629,05,02,06,29,4450,653,4117,3797,320,333,100.0,14.674157303370785,92.51685393258427,85.32584269662922,7.191011235955057,7.48314606741573
05030730,05,03,07,30,3983,2104,3281,1879,1402,702,100.0,52.824504142606074,82.37509415013808,47.175495857393926,35.19959829274416,17.624905849861914
05030731,05,03,07,31,11697,4777,9459,6920,2539,2238,100.0,40.839531503804395,80.86688894588356,59.160468496195605,21.706420449687954,19.13311105411644
05030832,05,03,08,32,11796,5051,8947,6745,2202,2849,100.0,42.819599864360804,75.8477449983045,57.180400135639196,18.66734486266531,24.15225500169549
05030833,05,03,08,33,1331,1045,394,286,108,937,100.0,78.51239669421489,29.601803155522166,21.487603305785125,8.114199849737041,70.39819684447784
05040934,05,04,09,34,3782,1069,3016,2713,303,766,100.0,28.265468006345852,79.74616604970915,71.73453199365414,8.011634056054998,20.25383395029085
05040935,05,04,09,35,435,104,368,331,37,67,100.0,23.908045977011493,84.59770114942529,76.0919540229885,8.505747126436782,15.402298850574713
05040936,05,04,09,36,9918,1585,9374,8333,1041,544,100.0,15.98104456543658,94.51502319015931,84.01895543456342,10.496067755595886,5.484976809840694
05040937,05,04,09,37,2159,301,2049,1858,191,110,100.0,13.941639647985179,94.90504863362668,86.05836035201482,8.846688281611858,5.094951366373321
05040938,05,04,09,38,3681,490,3481,3191,290,200,100.0,13.311600108666125,94.5666938331975,86.68839989133387,7.878293941863625,5.433306166802499
06010101,06,01,01,01,6859,1604,6006,5255,751,853,100.0,23.385333138941537,87.56378480828108,76.61466686105847,10.949117947222627,12.43621519171891
06010102,06,01,01,02,8764,2982,7111,5782,1329,1653,100.0,34.025559105431306,81.13874942948426,65.97444089456869,15.164308534915563,18.861250570515747
06010103,06,01,01,03,6365,1885,5396,4480,916,969,100.0,29.615082482325217,84.77611940298507,70.38491751767478,14.39120188531029,15.223880597014924
06010204,06,01,02,04,6930,2213,5841,4717,1124,1089,100.0,31.933621933621936,84.28571428571429,68.06637806637806,16.21933621933622,15.714285714285714
06010205,06,01,02,05,9613,2735,8244,6878,1366,1369,100.0,28.451055861853742,85.75886819931343,71.54894413814627,14.20992406116717,14.24113180068657
06010206,06,01,02,06,7686,2105,6559,5581,978,1127,100.0,27.38745771532657,85.33697632058288,72.61254228467344,12.724434035909447,14.663023679417122
06010207,06,01,02,07,7819,2393,6566,5426,1140,1253,100.0,30.604936692671696,83.97493285586393,69.3950633073283,14.579869548535617,16.02506714413608
06010208,06,01,02,08,6715,1907,5715,4808,907,1000,100.0,28.399106478034252,85.10796723752793,71.60089352196574,13.507073715562173,14.892032762472077
06010209,06,01,02,09,9150,2807,7657,6343,1314,1493,100.0,30.6775956284153,83.68306010928961,69.3224043715847,14.360655737704919,16.316939890710383
06010210,06,01,02,10,4923,1313,4223,3610,613,700,100.0,26.670729230144218,85.78102782855981,73.32927076985578,12.451757058704043,14.218972171440178
06020301,06,02,03,01,5004,1058,4507,3946,561,497,100.0,21.14308553157474,90.06794564348522,78.85691446842526,11.211031175059953,9.932054356514788
06020302,06,02,03,02,5524,1254,4914,4270,644,610,100.0,22.700941346850108,88.95727733526431,77.29905865314988,11.658218682114411,11.042722664735699
06020303,06,02,03,03,7405,2041,6359,5364,995,1046,100.0,27.562457798784607,85.87440918298446,72.4375422012154,13.436866981769075,14.12559081701553
06020304,06,02,03,04,6743,1770,5840,4973,867,903,100.0,26.249443867714668,86.60833456918286,73.75055613228533,12.857778436897524,13.391665430817143
06020305,06,02,03,05,11666,3825,9588,7841,1747,2078,100.0,32.787587862163555,82.18755357448997,67.21241213783645,14.975141436653521,17.81244642551003
06020306,06,02,03,06,6455,1182,5963,5273,690,492,100.0,18.31138652207591,92.37800154918668,81.6886134779241,10.689388071262588,7.621998450813323
06020407,06,02,04,07,4606,2151,3543,2455,1088,1063,100.0,46.69995657837603,76.9214068606166,53.30004342162397,23.621363438992617,23.078593139383415
06020408,06,02,04,08,6864,1761,5863,5103,760,1001,100.0,25.655594405594407,85.41666666666666,74.3444055944056,11.072261072261073,14.583333333333334
06020409,06,02,04,09,8251,2023,7133,6228,905,1118,100.0,24.518240213307475,86.45012725730214,75.48175978669252,10.968367470609623,13.549872742697854
06020410,06,02,04,10,7075,1255,6380,5820,560,695,100.0,17.73851590106007,90.17667844522968,82.26148409893993,7.915194346289753,9.823321554770319
06020411,06,02,04,11,8546,1930,7679,6616,1063,867,100.0,22.58366487245495,89.85490287853966,77.41633512754505,12.438567750994617,10.145097121460331
06030501,06,03,05,01,5834,1324,4956,4510,446,878,100.0,22.694549194377785,84.95029139526912,77.30545080562221,7.644840589646898,15.049708604730888
06030502,06,03,05,02,5649,1265,4968,4384,584,681,100.0,22.393343954682244,87.94476898566118,77.60665604531776,10.338112940343423,12.05523101433882
06030503,06,03,05,03,11720,3094,10122,8626,1496,1598,100.0,26.399317406143346,86.36518771331058,73.60068259385666,12.764505119453926,13.63481228668942
06030504,06,03,05,04,11042,2249,9880,8793,1087,1162,100.0,20.367687013222245,89.47654410432892,79.63231298677775,9.844231117551168,10.523455895671074
06030605,06,03,06,05,6913,1823,5896,5090,806,1017,100.0,26.37060610444091,85.2885867206712,73.62939389555909,11.659192825112108,14.7114132793288
06030606,06,03,06,06,5232,1634,4313,3598,715,919,100.0,31.230886850152906,82.43501529051987,68.7691131498471,13.665902140672785,17.56498470948012
06030607,06,03,06,07,2968,977,2317,1991,326,651,100.0,32.91778975741239,78.06603773584906,67.0822102425876,10.983827493261455,21.933962264150946
06030608,06,03,06,08,13364,3408,11730,9956,1774,1634,100.0,25.50134690212511,87.77312181981442,74.4986530978749,13.27446872193954,12.226878180185572
06030609,06,03,06,09,12105,2815,10562,9290,1272,1543,100.0,23.254853366377528,87.25320115654688,76.74514663362247,10.508054522924411,12.746798843453119
06030610,06,03,06,10,8329,1756,7363,6573,790,966,100.0,21.082963140833233,88.40196902389242,78.91703685916677,9.484932164725656,11.598030976107577
06040701,06,04,07,01,10200,2122,9005,8078,927,1195,100.0,20.80392156862745,88.2843137254902,79.19607843137256,9.088235294117647,11.715686274509803
06040702,06,04,07,02,5301,1012,4871,4289,582,430,100.0,19.090737596679872,91.88832295793247,80.90926240332013,10.979060554612337,8.111677042067535
06040703,06,04,07,03,11013,2919,8954,8094,860,2059,100.0,26.505039498774174,81.30391355670571,73.49496050122582,7.808953055479888,18.696086443294288
06040804,06,04,08,04,7576,1275,6904,6301,603,672,100.0,16.829461457233368,91.129883843717,83.17053854276664,7.959345300950369,8.870116156282998
06040805,06,04,08,05,5405,1135,4831,4270,561,574,100.0,20.999074930619795,89.38020351526364,79.0009250693802,10.379278445883442,10.619796484736355
06040806,06,04,08,06,7283,1086,6713,6197,516,570,100.0,14.911437594397913,92.17355485376905,85.08856240560209,7.084992448166965,7.826445146230948
06040807,06,04,08,07,5753,1217,5111,4536,575,642,100.0,21.154180427602988,88.84060490179037,78.84581957239702,9.99478532939336,11.15939509820963
06040808,06,04,08,08,4594,1708,3912,2886,1026,682,100.0,37.17892903787549,85.15454941227688,62.821070962124516,22.333478450152374,14.845450587723116
06040809,06,04,08,09,5120,1627,4029,3493,536,1091,100.0,31.777343749999996,78.69140625,68.22265625,10.46875,21.30859375
06040810,06,04,08,10,7066,2006,5933,5060,873,1133,100.0,28.38947070478347,83.96546844041892,71.61052929521652,12.354939145202378,16.03453155958109
07010101,07,01,01,01,10163,4931,7018,5232,1786,3145,100.0,48.519138049788445,69.05441306700777,51.480861950211555,17.57355111679622,30.945586932992224
07010102,07,01,01,02,16427,9074,10740,7353,3387,5687,100.0,55.23832714433554,65.38016679856334,44.76167285566445,20.618493942898887,34.61983320143666
07010103,07,01,01,03,10427,3855,8101,6572,1529,2326,100.0,36.97132444614942,77.69252901122087,63.028675553850576,14.663853457370287,22.307470988779134
07010104,07,01,01,04,13722,7818,8909,5904,3005,4813,100.0,56.974202011368604,64.92493805567702,43.02579798863139,21.899140067045618,35.07506194432298
07020201,07,02,02,01,10522,3552,8562,6970,1592,1960,100.0,33.757840714693025,81.37236266869417,66.24215928530698,15.130203383387189,18.627637331305834
07020202,07,02,02,02,10214,4255,7659,5959,1700,2555,100.0,41.658507930291755,74.98531427452517,58.341492069708245,16.643822204816917,25.014685725474838
07020203,07,02,02,03,17892,7660,13361,10232,3129,4531,100.0,42.8124301363738,74.67583277442432,57.187569863626194,17.48826291079812,25.32416722557568
07020204,07,02,02,04,11867,4168,9391,7699,1692,2476,100.0,35.1226089154799,79.135417544451,64.8773910845201,14.2580264599309,20.864582455549
07030301,07,03,03,01,24781,6551,21144,18230,2914,3637,100.0,26.435575642629434,85.32343327549331,73.56442435737056,11.759008918122756,14.676566724506678
07030302,07,03,03,02,9333,2813,7850,6520,1330,1483,100.0,30.14036215579128,84.11014679095682,69.85963784420872,14.250508946748097,15.889853209043181
07030303,07,03,03,03,12400,5214,9716,7186,2530,2684,100.0,42.04838709677419,78.35483870967742,57.9516129032258,20.403225806451612,21.64516129032258
07040401,07,04,04,01,18153,6927,14478,11226,3252,3675,100.0,38.158981986448524,79.75541232854074,61.841018013551476,17.914394314989256,20.244587671459264
07040402,07,04,04,02,2338,472,2147,1866,281,191,100.0,20.188195038494438,91.830624465355,79.81180496150556,12.018819503849445,8.169375534644995
07040403,07,04,04,03,23954,8509,19293,15445,3848,4661,100.0,35.522250981047,80.54187192118226,64.47774901895299,16.064122902229272,19.458128078817737
07040404,07,04,04,04,5112,1260,4501,3852,649,611,100.0,24.647887323943664,88.04773082942097,75.35211267605634,12.695618153364633,11.95226917057903
07040405,07,04,04,05,11000,4513,8464,6487,1977,2536,100.0,41.02727272727273,76.94545454545455,58.972727272727276,17.972727272727273,23.054545454545455
07040406,07,04,04,06,4040,2162,2686,1878,808,1354,100.0,53.51485148514852,66.48514851485149,46.48514851485149,20.0,33.51485148514852
07050501,07,05,05,01,16131,6061,13051,10070,2981,3080,100.0,37.5736160188457,80.90632942780981,62.4263839811543,18.479945446655506,19.093670572190195
07050502,07,05,05,02,8240,3007,6499,5233,1266,1741,100.0,36.49271844660194,78.87135922330097,63.50728155339805,15.364077669902912,21.12864077669903
07050503,07,05,05,03,9176,2762,7822,6414,1408,1354,100.0,30.100261551874457,85.24411508282476,69.89973844812555,15.344376634699216,14.75588491717524
07050504,07,05,05,04,5602,1721,4845,3881,964,757,100.0,30.721171010353444,86.48696893966441,69.27882898964656,17.208139950017852,13.513031060335596
07050505,07,05,05,05,10628,2820,9379,7808,1571,1249,100.0,26.533684606699286,88.24802408731652,73.46631539330072,14.781708694015808,11.751975912683479
07050506,07,05,05,06,2272,537,2027,1735,292,245,100.0,23.635563380281692,89.21654929577466,76.36443661971832,12.852112676056338,10.783450704225352
07060601,07,06,06,01,10174,3990,7990,6184,1806,2184,100.0,39.21761352467073,78.53351680754865,60.782386475329275,17.751130332219383,21.466483192451346
07060602,07,06,06,02,4703,1045,4242,3658,584,461,100.0,22.21985966404423,90.19774611949819,77.78014033595578,12.41760578354242,9.802253880501807
07060603,07,06,06,03,3208,1371,2388,1837,551,820,100.0,42.736907730673316,74.43890274314214,57.26309226932669,17.17581047381546,25.561097256857856
07060604,07,06,06,04,14349,5089,12430,9260,3170,1919,100.0,35.465886124468604,86.62624573140985,64.53411387553139,22.092131855878456,13.373754268590146
07070701,07,07,07,01,10571,2106,9620,8465,1155,951,100.0,19.922429287673822,91.00368933875697,80.07757071232618,10.926118626430801,8.996310661243022
07070702,07,07,07,02,10822,1978,10085,8844,1241,737,100.0,18.27758270190353,93.18979855849196,81.72241729809647,11.46738126039549,6.810201441508039
07070703,07,07,07,03,7351,1708,6583,5643,940,768,100.0,23.234934022581964,89.55244184464699,76.76506597741803,12.787375867228947,10.447558155353013
07070704,07,07,07,04,8463,3098,6843,5365,1478,1620,100.0,36.60640434833983,80.85785182559377,63.39359565166017,17.46425617393359,19.14214817440624
07070705,07,07,07,05,7033,1120,6553,5913,640,480,100.0,15.924925351912414,93.17503199203753,84.0750746480876,9.099957343949951,6.824968007962464
07070706,07,07,07,06,3904,770,3404,3134,270,500,100.0,19.723360655737704,87.19262295081968,80.27663934426229,6.915983606557377,12.807377049180326
07070707,07,07,07,07,2955,455,2716,2500,216,239,100.0,15.397631133671744,91.91201353637902,84.60236886632826,7.309644670050762,8.087986463620982
08010115,08,01,01,15,880,365,634,515,119,246,100.0,41.47727272727273,72.04545454545455,58.52272727272727,13.522727272727272,27.954545454545453
08010116,08,01,01,16,3573,2002,2250,1571,679,1323,100.0,56.03134620766863,62.97229219143576,43.968653792331374,19.003638399104396,37.02770780856423
08010117,08,01,01,17,16067,7930,10701,8137,2564,5366,100.0,49.35582249330926,66.6023526482853,50.64417750669074,15.958175141594571,33.397647351714696
08010118,08,01,01,18,11833,7002,7511,4831,2680,4322,100.0,59.17349784500971,63.475027465562405,40.82650215499028,22.64852531057213,36.52497253443759
08010211,08,01,02,11,9981,5793,6056,4188,1868,3925,100.0,58.04027652539826,60.67528303777176,41.959723474601745,18.71555956317002,39.32471696222824
08010212,08,01,02,12,7437,4894,4957,2543,2414,2480,100.0,65.80610461207476,66.65322038456367,34.19389538792524,32.45932499663843,33.34677961543633
08010213,08,01,02,13,12669,6785,8225,5884,2341,4444,100.0,53.555923908753655,64.92225116425921,46.44407609124635,18.478175073012867,35.077748835740785
08010214,08,01,02,14,8043,4457,5212,3586,1626,2831,100.0,55.41464627626508,64.80169091135149,44.585353723734926,20.216337187616563,35.198309088648514
08010301,08,01,03,01,27811,13227,19237,14584,4653,8574,100.0,47.56031785983963,69.17047211535005,52.43968214016037,16.730789975189673,30.82952788464996
08010302,08,01,03,02,3709,1301,2921,2408,513,788,100.0,35.07684011863036,78.7543812348342,64.92315988136964,13.831221353464546,21.245618765165812
08010303,08,01,03,03,8580,5243,5055,3337,1718,3525,100.0,61.10722610722611,58.91608391608392,38.89277389277389,20.023310023310025,41.08391608391608
08010404,08,01,04,04,23888,12649,15451,11239,4212,8437,100.0,52.95127260549229,64.6810113864702,47.0487273945077,17.632283991962492,35.318988613529804
08010405,08,01,04,05,9086,4222,6226,4864,1362,2860,100.0,46.467092229804095,68.52300242130751,53.532907770195905,14.9900946511116,31.476997578692494
08010406,08,01,04,06,7159,4090,4479,3069,1410,2680,100.0,57.13088420170415,62.56460399497137,42.86911579829585,19.695488196675516,37.435396005028636
08010407,08,01,04,07,804,347,572,457,115,232,100.0,43.159203980099505,71.14427860696517,56.840796019900495,14.303482587064675,28.855721393034827
08010508,08,01,05,08,5653,3957,3791,1696,2095,1862,100.0,69.99823102777286,67.06173713072705,30.00176897222714,37.05996815849991,32.938262869272954
08010509,08,01,05,09,9553,6179,6748,3374,3374,2805,100.0,64.68125196273422,70.63749607453155,35.31874803726578,35.31874803726578,29.36250392546844
08010510,08,01,05,10,480,334,215,146,69,265,100.0,69.58333333333333,44.79166666666667,30.416666666666664,14.374999999999998,55.208333333333336
08020619,08,02,06,19,11002,5791,7573,5211,2362,3429,100.0,52.63588438465734,68.83293946555172,47.36411561534267,21.468823850209056,31.167060534448282
08020620,08,02,06,20,9298,3939,7375,5359,2016,1923,100.0,42.36394923639492,79.3181329318133,57.63605076360507,21.68208216820822,20.68186706818671
08020621,08,02,06,21,2309,563,2116,1746,370,193,100.0,24.382849718492857,91.64140320485058,75.61715028150715,16.024252923343436,8.358596795149415
08020622,08,02,06,22,14205,3793,12426,10412,2014,1779,100.0,26.70186554030271,87.47624076029568,73.2981344596973,14.178106300598381,12.52375923970433
08020623,08,02,06,23,1274,362,1112,912,200,162,100.0,28.414442700156982,87.28414442700158,71.58555729984302,15.698587127158556,12.71585557299843
08020624,08,02,06,24,1314,424,1154,890,264,160,100.0,32.26788432267884,87.8234398782344,67.73211567732116,20.091324200913242,12.1765601217656
08020625,08,02,06,25,3377,957,2868,2420,448,509,100.0,28.338762214983714,84.9274503997631,71.66123778501628,13.266212614746816,15.072549600236895
08020726,08,02,07,26,8346,1926,7515,6420,1095,831,100.0,23.076923076923077,90.0431344356578,76.92307692307693,13.120057512580876,9.9568655643422
08020727,08,02,07,27,11959,3399,10351,8560,1791,1608,100.0,28.422108871979262,86.55405970398863,71.57789112802074,14.976168575967892,13.445940296011372
08020728,08,02,07,28,8564,3382,6833,5182,1651,1731,100.0,39.49089210649229,79.78748248482019,60.50910789350771,19.27837459131247,20.212517515179822
08030829,08,03,08,29,12494,6076,10046,6418,3628,2448,100.0,48.631343044661435,80.40659516567953,51.368656955338565,29.037938210340965,19.593404834320474
08030830,08,03,08,30,7387,2831,6282,4556,1726,1105,100.0,38.324082848246924,85.04128875050765,61.675917151753076,23.36537159875457,14.958711249492351
08030831,08,03,08,31,16999,8150,13735,8849,4886,3264,100.0,47.94399670568857,80.7988705217954,52.056003294311424,28.74286722748397,19.2011294782046
08040932,08,04,09,32,2857,860,2516,1997,519,341,100.0,30.101505075253765,88.064403220161,69.89849492474623,18.16590829541477,11.935596779838992
08040933,08,04,09,33,4151,1248,3604,2903,701,547,100.0,30.065044567574077,86.82245242110335,69.93495543242591,16.887496988677427,13.17754757889665
08040934,08,04,09,34,2663,776,2361,1887,474,302,100.0,29.140067592940294,88.65940668419077,70.85993240705972,17.799474277131054,11.340593315809237
08041035,08,04,10,35,8108,2430,7100,5678,1422,1008,100.0,29.97039960532807,87.56783423778984,70.02960039467193,17.538233843117908,12.432165762210163
08041036,08,04,10,36,6813,1437,6252,5376,876,561,100.0,21.092029942756497,91.76574196389255,78.9079700572435,12.857771906649054,8.234258036107441
08041037,08,04,10,37,9688,2234,8688,7454,1234,1000,100.0,23.05945499587118,89.67795210569777,76.94054500412882,12.737407101568952,10.322047894302228
08041038,08,04,10,38,6842,1449,6342,5393,949,500,100.0,21.178018123355745,92.69219526454253,78.82198187664426,13.870213387898275,7.307804735457468
08041039,08,04,10,39,3853,1081,3502,2772,730,351,100.0,28.056060212821176,90.89021541655853,71.94393978717882,18.946275629379706,9.109784583441474
08041040,08,04,10,40,7950,1753,7285,6197,1088,665,100.0,22.050314465408803,91.63522012578616,77.9496855345912,13.685534591194967,8.364779874213836
09010101,09,01,01,01,12103,3492,9916,8611,1305,2187,100.0,28.852350656861937,81.93009997521276,71.14764934313807,10.782450632074692,18.06990002478724
09010102,09,01,01,02,72,15,60,57,3,12,100.0,20.833333333333336,83.33333333333334,79.16666666666666,4.166666666666666,16.666666666666664
09010201,09,01,02,01,4320,669,3973,3651,322,347,100.0,15.48611111111111,91.9675925925926,84.51388888888889,7.453703703703704,8.032407407407408
09010202,09,01,02,02,6872,936,6254,5936,318,618,100.0,13.62048894062864,91.0069848661234,86.37951105937137,4.627473806752038,8.9930151338766
09010301,09,01,03,01,15512,2035,14297,13477,820,1215,100.0,13.118875709128416,92.16735430634347,86.88112429087158,5.286230015471893,7.8326456936565245
09010302,09,01,03,02,2906,606,2647,2300,347,259,100.0,20.85340674466621,91.0874053682037,79.1465932553338,11.940812112869924,8.912594631796283
09010401,09,01,04,01,8294,623,7941,7671,270,353,100.0,7.511454063178201,95.74391126115263,92.4885459368218,3.2553653243308416,4.256088738847359
09010402,09,01,04,02,11469,1860,10311,9609,702,1158,100.0,16.217630133403084,89.90321736855871,83.78236986659692,6.12084750196181,10.096782631441277
09020501,09,02,05,01,6820,1725,5520,5095,425,1300,100.0,25.29325513196481,80.93841642228739,74.70674486803519,6.231671554252199,19.06158357771261
09020502,09,02,05,02,15072,2645,13318,12427,891,1754,100.0,17.549097664543524,88.36252653927814,82.45090233545648,5.911624203821656,11.637473460721868
09020601,09,02,06,01,8006,1649,6792,6357,435,1214,100.0,20.597052210841866,84.83637272045965,79.40294778915813,5.433424931301524,15.163627279540345
09020602,09,02,06,02,3513,187,3420,3326,94,93,100.0,5.323085681753487,97.35269000853971,94.6769143182465,2.6757756902931966,2.6473099914602902
09020701,09,02,07,01,1771,774,1124,997,127,647,100.0,43.70412196499153,63.466967814793904,56.29587803500847,7.171089779785432,36.533032185206096
09020702,09,02,07,02,16131,2005,14716,14126,590,1415,100.0,12.429483603000433,91.22807017543859,87.57051639699957,3.65755377843903,8.771929824561402
09020801,09,02,08,01,2946,228,2805,2718,87,141,100.0,7.739307535641547,95.21384928716904,92.26069246435846,2.9531568228105907,4.786150712830957
09020802,09,02,08,02,7805,1234,6960,6571,389,845,100.0,15.81037796284433,89.1736066623959,84.18962203715566,4.983984625240231,10.826393337604099
09030901,09,03,09,01,13018,1579,12257,11439,818,761,100.0,12.129359348594255,94.15424796435704,87.87064065140575,6.283607312951298,5.845752035642956
09030902,09,03,09,02,5714,661,5395,5053,342,319,100.0,11.568078403920195,94.41722086104305,88.4319215960798,5.985299264963248,5.582779138956948
09030903,09,03,09,03,8091,1277,7507,6814,693,584,100.0,15.782968730688419,92.78210357186998,84.21703126931158,8.565072302558399,7.21789642813002
09031001,09,03,10,01,12892,1408,11991,11484,507,901,100.0,10.921501706484642,93.01116971765437,89.07849829351537,3.9326714241390013,6.988830282345641
09031101,09,03,11,01,6131,696,5631,5435,196,500,100.0,11.352144837709998,91.84472353612787,88.64785516229,3.196868373837873,8.155276463872125
09031201,09,03,12,01,1817,141,1750,1676,74,67,100.0,7.760044028618602,96.31260319207485,92.23995597138139,4.072647220693451,3.6873968079251513
09031202,09,03,12,02,2527,223,2393,2304,89,134,100.0,8.824693312227938,94.69726948951326,91.17530668777206,3.521962801741195,5.302730510486743
09041301,09,04,13,01,14537,1127,13757,13410,347,780,100.0,7.75263121689482,94.63438123409232,92.24736878310517,2.3870124509871364,5.3656187659076835
09041302,09,04,13,02,1856,165,1778,1691,87,78,100.0,8.890086206896552,95.79741379310344,91.10991379310344,4.6875,4.202586206896552
09041401,09,04,14,01,5016,567,4575,4449,126,441,100.0,11.303827751196172,91.20813397129187,88.69617224880383,2.511961722488038,8.791866028708133
09041402,09,04,14,02,1501,154,1438,1347,91,63,100.0,10.259826782145238,95.80279813457695,89.74017321785477,6.062624916722186,4.197201865423051
09041501,09,04,15,01,7615,1163,6854,6452,402,761,100.0,15.272488509520683,90.00656598818122,84.72751149047932,5.279054497701904,9.99343401181878
09041601,09,04,16,01,6619,371,6455,6248,207,164,100.0,5.605076295512918,97.52228433298082,94.39492370448708,3.12736062849373,2.4777156670191873
09051701,09,05,17,01,3659,254,3482,3405,77,177,100.0,6.941787373599344,95.16261273572015,93.05821262640066,2.104400109319486,4.837387264279858
09051702,09,05,17,02,14749,918,14260,13831,429,489,100.0,6.22415078988406,96.68452098447352,93.77584921011594,2.9086717743575834,3.3154790155264764
09051801,09,05,18,01,9438,803,8914,8635,279,524,100.0,8.508158508158509,94.44797626615808,91.4918414918415,2.9561347743165927,5.552023733841915
09051901,09,05,19,01,10895,997,10292,9898,394,603,100.0,9.150986691142727,94.46535107847637,90.84901330885728,3.6163377696190913,5.534648921523635
09052001,09,05,20,01,12856,758,12427,12098,329,429,100.0,5.89607965152458,96.66303671437461,94.10392034847543,2.559116365899191,3.336963285625389
10010101,10,01,01,01,5685,1452,4954,4233,721,731,100.0,25.540897097625333,87.14160070360599,74.45910290237467,12.68249780123131,12.858399296394019
10010102,10,01,01,02,18367,4499,16278,13868,2410,2089,100.0,24.495018239233406,88.62634071976915,75.50498176076658,13.121358959002558,11.37365928023085
10010203,10,01,02,03,1517,1054,510,463,47,1007,100.0,69.47923533289388,33.618984838497035,30.520764667106132,3.0982201713909028,66.38101516150297
10010204,10,01,02,04,10582,2254,9598,8328,1270,984,100.0,21.3003213003213,90.7011907011907,78.6996786996787,12.001512001512001,9.2988092988093
10010205,10,01,02,05,8150,1096,7589,7054,535,561,100.0,13.447852760736195,93.11656441717791,86.5521472392638,6.56441717791411,6.883435582822085
10010206,10,01,02,06,17141,3566,15148,13575,1573,1993,100.0,20.803920424712675,88.37290706493204,79.19607957528733,9.176827489644712,11.627092935067965
10010207,10,01,02,07,10793,2370,9725,8423,1302,1068,100.0,21.958676920226072,90.10469748911332,78.04132307977393,12.063374409339387,9.895302510886687
10010308,10,01,03,08,2528,858,1875,1670,205,653,100.0,33.939873417721515,74.16930379746836,66.06012658227847,8.109177215189874,25.830696202531644
10010309,10,01,03,09,14393,2890,13238,11503,1735,1155,100.0,20.079205169179463,91.97526575418607,79.92079483082054,12.054470923365525,8.024734245813937
10010310,10,01,03,10,18238,3628,16488,14610,1878,1750,100.0,19.892532075885512,90.40464963263516,80.10746792411449,10.297181708520672,9.595350367364842
10010311,10,01,03,11,2912,370,2804,2542,262,108,100.0,12.706043956043956,96.29120879120879,87.29395604395604,8.997252747252746,3.708791208791209
10020412,10,02,04,12,6790,1850,5859,4940,919,931,100.0,27.245949926362297,86.28865979381443,72.7540500736377,13.53460972017673,13.711340206185568
10020413,10,02,04,13,15590,2705,13927,12885,1042,1663,100.0,17.35086593970494,89.33290570878768,82.64913406029505,6.683771648492623,10.667094291212315
10020414,10,02,04,14,1687,655,1468,1032,436,219,100.0,38.826318909306465,87.01837581505632,61.17368109069354,25.84469472436278,12.981624184943689
10020415,10,02,04,15,5619,1413,4601,4206,395,1018,100.0,25.14682327816337,81.8828973126891,74.85317672183662,7.029720590852465,18.11710268731091
10020416,10,02,04,16,5608,1410,4679,4198,481,929,100.0,25.14265335235378,83.43437945791726,74.85734664764621,8.577032810271042,16.56562054208274
10020517,10,02,05,17,8832,801,8454,8031,423,378,100.0,9.06929347826087,95.72010869565217,90.93070652173914,4.789402173913043,4.279891304347826
10020518,10,02,05,18,5211,779,4734,4432,302,477,100.0,14.949146037228939,90.84628670120898,85.05085396277106,5.79543273843792,9.153713298791018
10020519,10,02,05,19,6135,1757,4847,4378,469,1288,100.0,28.638956805215976,79.00570497147514,71.36104319478403,7.644661776691117,20.994295028524856
10020620,10,02,06,20,3356,477,3141,2879,262,215,100.0,14.213349225268177,93.59356376638856,85.78665077473183,7.806912991656734,6.406436233611442
10020621,10,02,06,21,6180,962,5627,5218,409,553,100.0,15.566343042071198,91.05177993527508,84.4336569579288,6.618122977346279,8.94822006472492
10020622,10,02,06,22,8627,989,8202,7638,564,425,100.0,11.464008345890807,95.07360612031994,88.5359916541092,6.537614466210734,4.926393879680075
10020623,10,02,06,23,6559,664,6301,5895,406,258,100.0,10.123494435127306,96.06647354779692,89.87650556487269,6.189967982924227,3.9335264522030795
10030724,10,03,07,24,7802,1142,7007,6660,347,795,100.0,14.637272494232247,89.81030504998718,85.36272750576775,4.447577544219431,10.189694950012818
10030725,10,03,07,25,6267,1148,5545,5119,426,722,100.0,18.318174565182705,88.47933620552098,81.6818254348173,6.797510770703687,11.520663794479018
10030726,10,03,07,26,3029,315,2895,2714,181,134,100.0,10.39947177286233,95.57609772202046,89.60052822713766,5.9755694948828,4.423902277979532
10030727,10,03,07,27,9373,824,9061,8549,512,312,100.0,8.791208791208792,96.67128987517337,91.20879120879121,5.462498666382162,3.3287101248266295
10040828,10,04,08,28,7774,539,7531,7235,296,243,100.0,6.933367635708773,96.87419603807564,93.06663236429122,3.8075636737844096,3.125803961924363
10040829,10,04,08,29,3780,281,3594,3499,95,186,100.0,7.433862433862434,95.07936507936508,92.56613756613757,2.513227513227513,4.920634920634921
10040830,10,04,08,30,7579,435,7403,7144,259,176,100.0,5.739543475392532,97.677793904209,94.26045652460748,3.41733737960153,2.3222060957910013
10040931,10,04,09,31,9494,650,9211,8844,367,283,100.0,6.846429323783443,97.01917000210659,93.15357067621656,3.865599325890036,2.980829997893406
10040932,10,04,09,32,4001,344,3818,3657,161,183,100.0,8.597850537365659,95.42614346413396,91.40214946263434,4.0239940014996245,4.5738565358660335
10040933,10,04,09,33,14862,820,14517,14042,475,345,100.0,5.517426995020858,97.67864352038757,94.48257300497914,3.1960705154084246,2.3213564796124344
11010101,11,01,01,01,602,57,572,545,27,30,100.0,9.46843853820598,95.01661129568106,90.53156146179401,4.485049833887043,4.983388704318937
11010102,11,01,01,02,2556,122,2505,2434,71,51,100.0,4.773082942097027,98.00469483568075,95.22691705790297,2.7777777777777777,1.9953051643192488
11010103,11,01,01,03,1557,365,1269,1192,77,288,100.0,23.442517662170843,81.5028901734104,76.55748233782916,4.945407835581246,18.497109826589593
11010204,11,01,02,04,8963,2438,7611,6525,1086,1352,100.0,27.200714046636172,84.91576481088921,72.79928595336382,12.116478857525383,15.084235189110789
11010205,11,01,02,05,6714,1671,5890,5043,847,824,100.0,24.888293118856122,87.72713732499255,75.11170688114387,12.615430443848673,12.272862675007447
11010206,11,01,02,06,6026,1208,5313,4818,495,713,100.0,20.046465316959843,88.16793893129771,79.95353468304016,8.214404248257551,11.83206106870229
11010207,11,01,02,07,7166,1300,6396,5866,530,770,100.0,18.141222439296676,89.25481440133966,81.85877756070332,7.396036840636339,10.74518559866034
11010308,11,01,03,08,11809,3065,10130,8744,1386,1679,100.0,25.954780252349902,85.78203065458548,74.0452197476501,11.736810906935387,14.217969345414513
11010309,11,01,03,09,9706,2299,8338,7407,931,1368,100.0,23.686379559035647,85.90562538635895,76.31362044096434,9.592004945394601,14.094374613641047
11010310,11,01,03,10,5336,591,5040,4745,295,296,100.0,11.075712143928037,94.45277361319341,88.92428785607196,5.528485757121439,5.547226386806597
11020411,11,02,04,11,9343,2186,7756,7157,599,1587,100.0,23.3971957615327,83.0140211923365,76.6028042384673,6.411216953869207,16.98597880766349
11020412,11,02,04,12,6697,1258,5923,5439,484,774,100.0,18.784530386740332,88.44258623264149,81.21546961325967,7.227116619381812,11.557413767358518
11020513,11,02,05,13,3990,748,3378,3242,136,612,100.0,18.746867167919802,84.66165413533835,81.2531328320802,3.4085213032581456,15.338345864661655
11020514,11,02,05,14,9296,1871,7826,7425,401,1470,100.0,20.126936316695353,84.1867469879518,79.87306368330465,4.31368330464716,15.813253012048193
11020515,11,02,05,15,14620,3243,12741,11377,1364,1879,100.0,22.181942544459645,87.14774281805747,77.81805745554036,9.3296853625171,12.852257181942544
11020516,11,02,05,16,3710,385,3533,3325,208,177,100.0,10.377358490566039,95.22911051212938,89.62264150943396,5.606469002695418,4.77088948787062
11030617,11,03,06,17,6051,1757,4987,4294,693,1064,100.0,29.036522888778716,82.41612956536109,70.96347711122128,11.45265245413981,17.5838704346389
11030618,11,03,06,18,15970,3636,13871,12334,1537,2099,100.0,22.76768941765811,86.85660613650596,77.2323105823419,9.624295554164057,13.143393863494051
11030619,11,03,06,19,10802,2996,9060,7806,1254,1742,100.0,27.73560451768191,83.8733567857804,72.2643954823181,11.608961303462321,16.126643214219587
11030720,11,03,07,20,5549,3431,2396,2118,278,3153,100.0,61.83096053342945,43.1789511623716,38.16903946657055,5.009911695801046,56.821048837628396
11030721,11,03,07,21,24576,5860,20467,18716,1751,4109,100.0,23.844401041666664,83.28043619791666,76.15559895833334,7.124837239583333,16.719563802083336
11030824,11,03,08,24,9997,3222,8079,6775,1304,1918,100.0,32.2296689006702,80.81424427328199,67.7703310993298,13.043913173952184,19.185755726718014
11040925,11,04,09,25,4061,822,3541,3239,302,520,100.0,20.24131987195272,87.19527210046788,79.75868012804727,7.436591972420587,12.804727899532134
11040926,11,04,09,26,28123,5096,24785,23027,1758,3338,100.0,18.120399672865624,88.13071151726345,81.87960032713437,6.251111190129076,11.86928848273655
11041022,11,04,10,22,5451,1698,4228,3753,475,1223,100.0,31.150247660979634,77.56374977068428,68.84975233902037,8.713997431663916,22.43625022931572
11041023,11,04,10,23,6083,1835,5049,4248,801,1034,100.0,30.166036495150415,83.00180831826401,69.83396350484958,13.167844813414433,16.998191681735985
11041027,11,04,10,27,2860,714,2421,2146,275,439,100.0,24.965034965034967,84.65034965034965,75.03496503496504,9.615384615384617,15.349650349650348
11041128,11,04,11,28,25120,5024,22164,20096,2068,2956,100.0,20.0,88.23248407643312,80.0,8.23248407643312,11.76751592356688
11051229,11,05,12,29,3523,496,3283,3027,256,240,100.0,14.07891001986943,93.18762418393415,85.92108998013057,7.266534203803577,6.812375816065853
11051330,11,05,13,30,9389,1566,8267,7823,444,1122,100.0,16.67909255511769,88.04984556395782,83.32090744488231,4.728938119075514,11.950154436042178
11051331,11,05,13,31,10932,1704,9725,9228,497,1207,100.0,15.587266739846322,88.95901939260885,84.41273326015367,4.546286132455178,11.040980607391147
11051332,11,05,13,32,6756,687,6453,6069,384,303,100.0,10.16873889875666,95.51509769094139,89.83126110124334,5.683836589698046,4.484902309058614
12103115,12,10,31,15,7619,3063,5889,4556,1333,1730,100.0,40.202126263289145,77.29360808505054,59.79787373671085,17.495734348339678,22.70639191494947
12103116,12,10,31,16,9511,4182,7084,5329,1755,2427,100.0,43.970139838082225,74.48217853012301,56.029860161917775,18.452318368205237,25.517821469876985
12103117,12,10,31,17,10819,5396,7558,5423,2135,3261,100.0,49.875219521212685,69.85858212404104,50.12478047878732,19.73380164525372,30.141417875958957
12103218,12,10,32,18,13566,5517,10534,8049,2485,3032,100.0,40.66784608580274,77.6500073713696,59.332153914197264,18.317853457172344,22.3499926286304
12103219,12,10,32,19,8748,3585,6801,5163,1638,1947,100.0,40.98079561042524,77.74348422496571,59.01920438957477,18.72427983539095,22.256515775034295
12103220,12,10,32,20,4639,1238,4011,3401,610,628,100.0,26.68678594524682,86.46259969821082,73.31321405475319,13.149385643457641,13.537400301789178
12214125,12,21,41,25,7375,2035,6284,5340,944,1091,100.0,27.59322033898305,85.20677966101695,72.40677966101696,12.8,14.793220338983051
12214126,12,21,41,26,7970,2823,6531,5147,1384,1439,100.0,35.42032622333752,81.94479297365119,64.57967377666249,17.365119196988708,18.055207026348807
12214421,12,21,44,21,2661,899,2144,1762,382,517,100.0,33.78429161969185,80.57121382938745,66.21570838030816,14.355505449079292,19.428786170612554
12214422,12,21,44,22,8149,4546,5602,3603,1999,2547,100.0,55.785986010553444,68.7446312430973,44.21401398944656,24.530617253650753,31.255368756902683
12214423,12,21,44,23,5575,2080,4584,3495,1089,991,100.0,37.309417040358746,82.22421524663676,62.69058295964126,19.533632286995516,17.775784753363226
12214424,12,21,44,24,10719,5160,7563,5559,2004,3156,100.0,48.138818919675344,70.55695493982648,51.861181080324656,18.69577385950182,29.443045060173525
12214527,12,21,45,27,10769,2087,9628,8682,946,1141,100.0,19.37970099359272,89.40477295942057,80.62029900640728,8.78447395301328,10.595227040579442
12214528,12,21,45,28,254,80,204,174,30,50,100.0,31.496062992125985,80.31496062992126,68.50393700787401,11.811023622047244,19.68503937007874
12224229,12,22,42,29,6046,751,5743,5295,448,303,100.0,12.421435659940457,94.98842209725439,87.57856434005954,7.409857757194839,5.011577902745617
12224230,12,22,42,30,17976,2093,17126,15883,1243,850,100.0,11.643302180685358,95.27147307521139,88.35669781931465,6.9147752558967515,4.728526924788607
12231101,12,23,11,01,16580,2022,15604,14558,1046,976,100.0,12.195416164053077,94.1133896260555,87.80458383594693,6.308805790108564,5.886610373944511
12231102,12,23,11,02,16836,1975,16010,14861,1149,826,100.0,11.730814920408648,95.09384651936327,88.26918507959135,6.824661439771917,4.906153480636731
12301203,12,30,12,03,15110,4345,12336,10765,1571,2774,100.0,28.755790866975513,81.64129715420252,71.24420913302448,10.397088021178028,18.358702845797485
12301204,12,30,12,04,6383,1473,5611,4910,701,772,100.0,23.076923076923077,87.9053736487545,76.92307692307693,10.982296725677582,12.094626351245495
12301205,12,30,12,05,4937,878,4532,4059,473,405,100.0,17.784079400445616,91.7966376341908,82.21592059955438,9.580717034636418,8.203362365809195
12301206,12,30,12,06,5098,754,4835,4344,491,263,100.0,14.790113770105922,94.84111416241663,85.20988622989407,9.631227932522558,5.158885837583366
12302107,12,30,21,07,3054,1175,2573,1879,694,481,100.0,38.474132285527176,84.25016371971185,61.525867714472824,22.72429600523903,15.749836280288147
12302108,12,30,21,08,14510,5854,11777,8656,3121,2733,100.0,40.344589937973815,81.16471399035147,59.65541006202619,21.509303928325295,18.83528600964852
12302109,12,30,21,09,11630,5765,8733,5865,2868,2897,100.0,49.5700773860705,75.09028374892519,50.42992261392949,24.6603611349957,24.909716251074805
12302110,12,30,21,10,10519,5576,7685,4943,2742,2834,100.0,53.0088411445955,73.05827550147353,46.99115885540451,26.067116646069017,26.941724498526476
12302211,12,30,22,11,3308,848,2942,2460,482,366,100.0,25.634824667472795,88.93591293833131,74.36517533252722,14.57073760580411,11.064087061668681
12302212,12,30,22,12,5940,2646,4273,3294,979,1667,100.0,44.54545454545455,71.93602693602693,55.45454545454545,16.48148148148148,28.063973063973062
12304313,12,30,43,13,6640,1407,5774,5233,541,866,100.0,21.18975903614458,86.9578313253012,78.81024096385542,8.147590361445783,13.042168674698795
12304314,12,30,43,14,9742,1276,9142,8466,676,600,100.0,13.097926503797988,93.84110039006363,86.90207349620202,6.93902689386163,6.158899609936358
